"data";"tot.pass";"est.pagantes";"est.grat";"tot.grat";"semana";"semana.num";"semana.dia1";"ano";"estudantes";"grat.no.est"
2019-01-05;4460022;23312;63752;738032;"2019-W01";1;2018-12-30;"2019";87064;674280
2019-01-05;4460022;23312;63752;738032;"2019-W01";1;2018-12-30;"2019";87064;674280
2019-01-06;2871400;15996;147;550583;"2019-W02";2;2019-01-06;"2019";16143;550436
2019-01-07;7841451;51843;17;1309389;"2019-W02";2;2019-01-06;"2019";51860;1309372
2019-01-08;7670794;46958;31;1241670;"2019-W02";2;2019-01-06;"2019";46989;1241639
2019-01-09;8149560;47843;38;1327389;"2019-W02";2;2019-01-06;"2019";47881;1327351
2019-01-10;8062619;44303;31;1277543;"2019-W02";2;2019-01-06;"2019";44334;1277512
2019-01-11;7879784;39622;35;1231923;"2019-W02";2;2019-01-06;"2019";39657;1231888
2019-01-12;5170220;22976;33;857558;"2019-W02";2;2019-01-06;"2019";23009;857525
2019-01-13;2858510;11934;12;533664;"2019-W03";3;2019-01-13;"2019";11946;533652
2019-01-14;7826329;38180;58;1249790;"2019-W03";3;2019-01-13;"2019";38238;1249732
2019-01-15;8132682;39101;38;1295928;"2019-W03";3;2019-01-13;"2019";39139;1295890
2019-01-16;8098925;37075;57;1279585;"2019-W03";3;2019-01-13;"2019";37132;1279528
2019-01-17;8063455;35503;35;1238384;"2019-W03";3;2019-01-13;"2019";35538;1238349
2019-01-18;8074793;33459;26;1241120;"2019-W03";3;2019-01-13;"2019";33485;1241094
2019-01-19;5213845;19036;30;846676;"2019-W03";3;2019-01-13;"2019";19066;846646
2019-01-20;2969429;10262;25;556207;"2019-W04";4;2019-01-20;"2019";10287;556182
2019-01-21;8019052;32301;37;1254979;"2019-W04";4;2019-01-20;"2019";32338;1254942
2019-01-22;8161893;32493;31;1251544;"2019-W04";4;2019-01-20;"2019";32524;1251513
2019-01-23;8220614;32831;42;1294844;"2019-W04";4;2019-01-20;"2019";32873;1294802
2019-01-24;7487838;27608;43;1149985;"2019-W04";4;2019-01-20;"2019";27651;1149942
2019-01-25;3232068;8833;23;521250;"2019-W04";4;2019-01-20;"2019";8856;521227
2019-01-26;4044156;11654;9;698297;"2019-W04";4;2019-01-20;"2019";11663;698288
2019-01-27;2889023;8022;16;563454;"2019-W05";5;2019-01-27;"2019";8038;563438
2019-01-28;8173408;32989;42;1322131;"2019-W05";5;2019-01-27;"2019";33031;1322089
2019-01-29;8212882;33826;33;1292020;"2019-W05";5;2019-01-27;"2019";33859;1291987
2019-01-30;8396625;33760;37;1337920;"2019-W05";5;2019-01-27;"2019";33797;1337883
2019-01-31;8477142;32491;40;1321300;"2019-W05";5;2019-01-27;"2019";32531;1321260
2019-02-01;8565761;37560;62614;1341236;"2019-W05";5;2019-01-27;"2019";100174;1278622
2019-02-02;5332887;21017;61950;867083;"2019-W05";5;2019-01-27;"2019";82967;805133
2019-02-03;2872336;10738;37275;547817;"2019-W06";6;2019-02-03;"2019";48013;510542
2019-02-04;7424481;54315;155871;1120494;"2019-W06";6;2019-02-03;"2019";210186;964623
2019-02-05;2796390;22701;66667;479052;"2019-W06";6;2019-02-03;"2019";89368;412385
2019-02-06;8103584;73603;231509;1103065;"2019-W06";6;2019-02-03;"2019";305112;871556
2019-02-07;9305889;91492;305128;1503032;"2019-W06";6;2019-02-03;"2019";396620;1197904
2019-02-08;9208158;92569;336009;1459300;"2019-W06";6;2019-02-03;"2019";428578;1123291
2019-02-09;5670440;38790;170897;943357;"2019-W06";6;2019-02-03;"2019";209687;772460
2019-02-10;3193049;19573;97797;608205;"2019-W07";7;2019-02-10;"2019";117370;510408
2019-02-11;9187744;115859;440207;1430937;"2019-W07";7;2019-02-10;"2019";556066;990730
2019-02-12;9121428;122604;455986;1380498;"2019-W07";7;2019-02-10;"2019";578590;924512
2019-02-13;8969314;126309;471802;1334464;"2019-W07";7;2019-02-10;"2019";598111;862662
2019-02-14;9201135;132102;512527;1392327;"2019-W07";7;2019-02-10;"2019";644629;879800
2019-02-15;8836979;123693;488404;1313314;"2019-W07";7;2019-02-10;"2019";612097;824910
2019-02-16;4808622;40593;200822;727661;"2019-W07";7;2019-02-10;"2019";241415;526839
2019-02-17;2978345;22972;126798;573386;"2019-W08";8;2019-02-17;"2019";149770;446588
2019-02-18;9148576;149672;578915;1388855;"2019-W08";8;2019-02-17;"2019";728587;809940
2019-02-19;9337114;161507;604193;1406749;"2019-W08";8;2019-02-17;"2019";765700;802556
2019-02-20;9350848;166120;621177;1410696;"2019-W08";8;2019-02-17;"2019";787297;789519
2019-02-21;9154291;165869;623739;1325399;"2019-W08";8;2019-02-17;"2019";789608;701660
2019-02-22;9037811;157135;599268;1331092;"2019-W08";8;2019-02-17;"2019";756403;731824
2019-02-23;5686414;67455;317861;895166;"2019-W08";8;2019-02-17;"2019";385316;577305
2019-02-24;3221731;35261;175344;588038;"2019-W09";9;2019-02-24;"2019";210605;412694
2019-02-25;8954501;171005;639345;1355899;"2019-W09";9;2019-02-24;"2019";810350;716554
2019-02-26;7827889;152197;537278;1084426;"2019-W09";9;2019-02-24;"2019";689475;547148
2019-02-27;9334482;181807;669753;1435401;"2019-W09";9;2019-02-24;"2019";851560;765648
2019-02-28;8837419;168055;619237;1247475;"2019-W09";9;2019-02-24;"2019";787292;628238
2019-03-01;8695427;145087;583040;1338371;"2019-W09";9;2019-02-24;"2019";728127;755331
2019-03-02;4855425;50095;273154;814940;"2019-W09";9;2019-02-24;"2019";323249;541786
2019-03-03;2849423;28828;165882;525240;"2019-W10";10;2019-03-03;"2019";194710;359358
2019-03-04;4596594;41198;228192;810051;"2019-W10";10;2019-03-03;"2019";269390;581859
2019-03-05;3275496;32411;184847;559057;"2019-W10";10;2019-03-03;"2019";217258;374210
2019-03-06;6715585;71972;252244;1121267;"2019-W10";10;2019-03-03;"2019";324216;869023
2019-03-07;8765130;163144;469239;1433576;"2019-W10";10;2019-03-03;"2019";632383;964337
2019-03-08;9009286;165956;521152;1523318;"2019-W10";10;2019-03-03;"2019";687108;1002166
2019-03-09;5477781;70255;323185;914112;"2019-W10";10;2019-03-03;"2019";393440;590927
2019-03-10;3097462;36063;190597;590475;"2019-W11";11;2019-03-10;"2019";226660;399878
2019-03-11;8680915;182362;673330;1373387;"2019-W11";11;2019-03-10;"2019";855692;700057
2019-03-12;9332705;210911;758442;1501564;"2019-W11";11;2019-03-10;"2019";969353;743122
2019-03-13;9302023;217238;783054;1464494;"2019-W11";11;2019-03-10;"2019";1000292;681440
2019-03-14;9138244;218010;781114;1395306;"2019-W11";11;2019-03-10;"2019";999124;614192
2019-03-15;8974324;204029;749399;1383333;"2019-W11";11;2019-03-10;"2019";953428;633934
2019-03-16;5360716;78180;358178;898009;"2019-W11";11;2019-03-10;"2019";436358;539831
2019-03-17;2833133;34027;178320;549842;"2019-W12";12;2019-03-17;"2019";212347;371522
2019-03-18;8487462;212121;754455;1310199;"2019-W12";12;2019-03-17;"2019";966576;555744
2019-03-19;9096233;229534;817102;1398406;"2019-W12";12;2019-03-17;"2019";1046636;581304
2019-03-20;9274731;236181;842107;1444287;"2019-W12";12;2019-03-17;"2019";1078288;602180
2019-03-21;8811742;228727;802900;1253379;"2019-W12";12;2019-03-17;"2019";1031627;450479
2019-03-22;8702228;212612;721073;1339484;"2019-W12";12;2019-03-17;"2019";933685;618411
2019-03-23;5406567;83345;383852;904762;"2019-W12";12;2019-03-17;"2019";467197;520910
2019-03-24;3021761;39159;202338;596309;"2019-W13";13;2019-03-24;"2019";241497;393971
2019-03-25;8956741;231033;830826;1402169;"2019-W13";13;2019-03-24;"2019";1061859;571343
2019-03-26;9154270;237914;838806;1427395;"2019-W13";13;2019-03-24;"2019";1076720;588589
2019-03-27;8976544;229487;811877;1421919;"2019-W13";13;2019-03-24;"2019";1041364;610042
2019-03-28;8777194;220379;767980;1348522;"2019-W13";13;2019-03-24;"2019";988359;580542
2019-03-29;8145486;184234;662478;1264022;"2019-W13";13;2019-03-24;"2019";846712;601544
2019-03-30;4520076;62578;284784;758335;"2019-W13";13;2019-03-24;"2019";347362;473551
2019-03-31;3033985;35938;179142;600717;"2019-W14";14;2019-03-31;"2019";215080;421575
2019-04-01;8754448;213127;808020;1390714;"2019-W14";14;2019-03-31;"2019";1021147;582694
2019-04-02;8705790;223783;829723;1380101;"2019-W14";14;2019-03-31;"2019";1053506;550378
2019-04-03;9317145;241303;897592;1493659;"2019-W14";14;2019-03-31;"2019";1138895;596067
2019-04-04;9291886;242292;897276;1457645;"2019-W14";14;2019-03-31;"2019";1139568;560369
2019-04-05;9281110;224811;862199;1470728;"2019-W14";14;2019-03-31;"2019";1087010;608529
2019-04-06;5437723;86163;362859;879479;"2019-W14";14;2019-03-31;"2019";449022;516620
2019-04-07;3087515;42690;200460;594315;"2019-W15";15;2019-04-07;"2019";243150;393855
2019-04-08;8490934;222448;743090;1241239;"2019-W15";15;2019-04-07;"2019";965538;498149
2019-04-09;8979991;243393;841453;1349157;"2019-W15";15;2019-04-07;"2019";1084846;507704
2019-04-10;9322353;250980;881902;1480206;"2019-W15";15;2019-04-07;"2019";1132882;598304
2019-04-11;9266536;253254;884587;1436110;"2019-W15";15;2019-04-07;"2019";1137841;551523
2019-04-12;9097634;236093;844529;1413062;"2019-W15";15;2019-04-07;"2019";1080622;568533
2019-04-13;5557948;95824;432045;935251;"2019-W15";15;2019-04-07;"2019";527869;503206
2019-04-14;2693801;38006;194424;496628;"2019-W16";16;2019-04-14;"2019";232430;302204
2019-04-15;8727972;236774;833541;1384284;"2019-W16";16;2019-04-14;"2019";1070315;550743
2019-04-16;8470639;233006;795557;1324681;"2019-W16";16;2019-04-14;"2019";1028563;529124
2019-04-17;9313873;252345;874458;1494625;"2019-W16";16;2019-04-14;"2019";1126803;620167
2019-04-18;9024724;206739;770001;1437105;"2019-W16";16;2019-04-14;"2019";976740;667104
2019-04-19;3202537;42895;232211;562139;"2019-W16";16;2019-04-14;"2019";275106;329928
2019-04-20;4820865;64952;349983;863000;"2019-W16";16;2019-04-14;"2019";414935;513017
2019-04-21;2887749;36173;206610;561969;"2019-W17";17;2019-04-21;"2019";242783;355359
2019-04-22;8796937;243364;857638;1362134;"2019-W17";17;2019-04-21;"2019";1101002;504496
2019-04-23;9078045;254787;881845;1405640;"2019-W17";17;2019-04-21;"2019";1136632;523795
2019-04-24;9080562;252379;866199;1431407;"2019-W17";17;2019-04-21;"2019";1118578;565208
2019-04-25;8633792;235596;800676;1330393;"2019-W17";17;2019-04-21;"2019";1036272;529717
2019-04-26;5591258;139330;457832;887931;"2019-W17";17;2019-04-21;"2019";597162;430099
2019-04-27;222729;3763;16669;37175;"2019-W17";17;2019-04-21;"2019";20432;20506
2019-04-28;2859596;37947;185404;559323;"2019-W18";18;2019-04-28;"2019";223351;373919
2019-04-29;8837209;222842;750527;1394448;"2019-W18";18;2019-04-28;"2019";973369;643921
2019-04-30;9161728;217243;718363;1492121;"2019-W18";18;2019-04-28;"2019";935606;773758
2019-05-01;3462276;46738;244141;648102;"2019-W18";18;2019-04-28;"2019";290879;403961
2019-05-02;9052702;231271;829729;1444622;"2019-W18";18;2019-04-28;"2019";1061000;614893
2019-05-03;9001240;226921;818128;1445984;"2019-W18";18;2019-04-28;"2019";1045049;627856
2019-05-04;5456171;92270;436311;939562;"2019-W18";18;2019-04-28;"2019";528581;503251
2019-05-05;3025943;44010;234246;595335;"2019-W19";19;2019-05-05;"2019";278256;361089
2019-05-06;8609668;243218;732090;1393070;"2019-W19";19;2019-05-05;"2019";975308;660980
2019-05-07;8388224;237752;773929;1333976;"2019-W19";19;2019-05-05;"2019";1011681;560047
2019-05-08;9483775;267781;904030;1545042;"2019-W19";19;2019-05-05;"2019";1171811;641012
2019-05-09;9358940;266586;907500;1470692;"2019-W19";19;2019-05-05;"2019";1174086;563192
2019-05-10;9209655;246515;866119;1461226;"2019-W19";19;2019-05-05;"2019";1112634;595107
2019-05-11;5645956;100630;451564;953853;"2019-W19";19;2019-05-05;"2019";552194;502289
2019-05-12;2949526;37179;206117;541724;"2019-W20";20;2019-05-12;"2019";243296;335607
2019-05-12;3010702;37930;210568;553859;"2019-W20";20;2019-05-12;"2019";248498;343291
2019-05-13;8682960;252708;875387;1349709;"2019-W20";20;2019-05-12;"2019";1128095;474322
2019-05-13;8960024;259483;906619;1394407;"2019-W20";20;2019-05-12;"2019";1166102;487788
2019-05-14;9077803;265028;915869;1401594;"2019-W20";20;2019-05-12;"2019";1180897;485725
2019-05-15;8830843;248335;734366;1411853;"2019-W20";20;2019-05-12;"2019";982701;677487
2019-05-16;8786528;257279;891653;1273701;"2019-W20";20;2019-05-12;"2019";1148932;382048
2019-05-17;8718013;238723;854617;1289737;"2019-W20";20;2019-05-12;"2019";1093340;435120
2019-05-18;4982168;88856;403371;789591;"2019-W20";20;2019-05-12;"2019";492227;386220
2019-05-19;2896428;46070;232014;552129;"2019-W21";21;2019-05-19;"2019";278084;320115
2019-05-20;8902574;255537;917204;1379908;"2019-W21";21;2019-05-19;"2019";1172741;462704
2019-05-21;9049583;259488;930270;1393960;"2019-W21";21;2019-05-19;"2019";1189758;463690
2019-05-22;8815368;248019;888238;1370058;"2019-W21";21;2019-05-19;"2019";1136257;481820
2019-05-23;9074447;254619;913023;1379553;"2019-W21";21;2019-05-19;"2019";1167642;466530
2019-05-24;8724711;230419;839832;1294649;"2019-W21";21;2019-05-19;"2019";1070251;454817
2019-05-25;5221562;89813;404971;867879;"2019-W21";21;2019-05-19;"2019";494784;462908
2019-05-26;2894538;41120;201675;567952;"2019-W22";22;2019-05-26;"2019";242795;366277
2019-05-27;8274316;222904;777234;1291023;"2019-W22";22;2019-05-26;"2019";1000138;513789
2019-05-28;8988011;236497;822347;1413353;"2019-W22";22;2019-05-26;"2019";1058844;591006
2019-05-29;8801109;223998;762690;1382022;"2019-W22";22;2019-05-26;"2019";986688;619332
2019-05-30;8594436;203955;680194;1329095;"2019-W22";22;2019-05-26;"2019";884149;648901
2019-05-31;7934485;174062;592063;1241518;"2019-W22";22;2019-05-26;"2019";766125;649455
2019-06-01;5188849;78247;385253;859514;"2019-W22";22;2019-05-26;"2019";463500;474261
2019-06-02;2557580;31947;181905;473214;"2019-W23";23;2019-06-02;"2019";213852;291309
2019-06-03;8326188;211874;810194;1256040;"2019-W23";23;2019-06-02;"2019";1022068;445846
2019-06-04;8977769;239786;917788;1417932;"2019-W23";23;2019-06-02;"2019";1157574;500144
2019-06-05;8879158;238928;900677;1384558;"2019-W23";23;2019-06-02;"2019";1139605;483881
2019-06-06;8925177;241799;816922;1406156;"2019-W23";23;2019-06-02;"2019";1058721;589234
2019-06-07;8863135;225009;800785;1430827;"2019-W23";23;2019-06-02;"2019";1025794;630042
2019-06-08;5390248;99146;445089;891164;"2019-W23";23;2019-06-02;"2019";544235;446075
2019-06-09;3067524;46468;235006;594843;"2019-W24";24;2019-06-09;"2019";281474;359837
2019-06-10;8992796;233586;871720;1458036;"2019-W24";24;2019-06-09;"2019";1105306;586316
2019-06-11;9177955;242721;896535;1446881;"2019-W24";24;2019-06-09;"2019";1139256;550346
2019-06-12;9191086;243494;899386;1452720;"2019-W24";24;2019-06-09;"2019";1142880;553334
2019-06-13;8946562;237515;865049;1388579;"2019-W24";24;2019-06-09;"2019";1102564;523530
2019-06-14;7066828;136764;522442;1097951;"2019-W24";24;2019-06-09;"2019";659206;575509
2019-06-15;5289433;96405;454582;882243;"2019-W24";24;2019-06-09;"2019";550987;427661
2019-06-16;2806483;43229;223841;539544;"2019-W25";25;2019-06-16;"2019";267070;315703
2019-06-17;8794311;221671;823996;1404710;"2019-W25";25;2019-06-16;"2019";1045667;580714
2019-06-18;8930808;223652;818499;1414550;"2019-W25";25;2019-06-16;"2019";1042151;596051
2019-06-19;8993608;217833;808218;1449183;"2019-W25";25;2019-06-16;"2019";1026051;640965
2019-06-20;3491965;53120;268317;610059;"2019-W25";25;2019-06-16;"2019";321437;341742
2019-06-21;6815793;107475;471145;1127419;"2019-W25";25;2019-06-16;"2019";578620;656274
2019-06-22;4964430;75135;384551;842453;"2019-W25";25;2019-06-16;"2019";459686;457902
2019-06-23;2912655;43038;230436;562776;"2019-W26";26;2019-06-23;"2019";273474;332340
2019-06-24;8388833;182824;686083;1373072;"2019-W26";26;2019-06-23;"2019";868907;686989
2019-06-25;8524670;182955;668419;1388649;"2019-W26";26;2019-06-23;"2019";851374;720230
2019-06-26;8247332;173238;618624;1347636;"2019-W26";26;2019-06-23;"2019";791862;729012
2019-06-27;8507430;170817;617569;1363171;"2019-W26";26;2019-06-23;"2019";788386;745602
2019-06-28;8411850;155069;568606;1380848;"2019-W26";26;2019-06-23;"2019";723675;812242
2019-06-29;5296695;79123;370792;900523;"2019-W26";26;2019-06-23;"2019";449915;529731
2019-06-30;2922822;39442;189812;573321;"2019-W27";27;2019-06-30;"2019";229254;383509
2019-07-01;8090344;123184;490105;1365389;"2019-W27";27;2019-06-30;"2019";613289;875284
2019-07-02;8244167;125459;497335;1386338;"2019-W27";27;2019-06-30;"2019";622794;889003
2019-07-03;8291081;123879;490012;1401992;"2019-W27";27;2019-06-30;"2019";613891;911980
2019-07-04;6976786;95756;370732;988224;"2019-W27";27;2019-06-30;"2019";466488;617492
2019-07-05;7652550;102573;420957;1209254;"2019-W27";27;2019-06-30;"2019";523530;788297
2019-07-06;5020914;59539;217287;855892;"2019-W27";27;2019-06-30;"2019";276826;638605
2019-07-07;2550751;27623;111789;470863;"2019-W28";28;2019-07-07;"2019";139412;359074
2019-07-08;6508267;73206;242832;1132487;"2019-W28";28;2019-07-07;"2019";316038;889655
2019-07-09;3169463;33300;138396;554043;"2019-W28";28;2019-07-07;"2019";171696;415647
2019-07-10;8280789;107281;329066;1443815;"2019-W28";28;2019-07-07;"2019";436347;1114749
2019-07-11;8180782;103693;327501;1362430;"2019-W28";28;2019-07-07;"2019";431194;1034929
2019-07-12;8092867;99231;331078;1343977;"2019-W28";28;2019-07-07;"2019";430309;1012899
2019-07-13;5207076;55946;241780;898146;"2019-W28";28;2019-07-07;"2019";297726;656366
2019-07-14;2951896;30358;137111;583071;"2019-W29";29;2019-07-14;"2019";167469;445960
2019-07-15;7838854;90137;294357;1326553;"2019-W29";29;2019-07-14;"2019";384494;1032196
2019-07-16;7697890;87474;278756;1214266;"2019-W29";29;2019-07-14;"2019";366230;935510
2019-07-17;7834360;87933;274600;1272965;"2019-W29";29;2019-07-14;"2019";362533;998365
2019-07-18;7916297;87835;270648;1278470;"2019-W29";29;2019-07-14;"2019";358483;1007822
2019-07-19;7931296;83580;262299;1290301;"2019-W29";29;2019-07-14;"2019";345879;1028002
2019-07-20;5131836;47420;192143;879663;"2019-W29";29;2019-07-14;"2019";239563;687520
2019-07-21;2905001;25567;110581;573447;"2019-W30";30;2019-07-21;"2019";136148;462866
2019-07-22;7896347;82210;246878;1304912;"2019-W30";30;2019-07-21;"2019";329088;1058034
2019-07-23;8184420;86537;271101;1346834;"2019-W30";30;2019-07-21;"2019";357638;1075733
2019-07-24;8271444;87313;281635;1369560;"2019-W30";30;2019-07-21;"2019";368948;1087925
2019-07-25;8226604;84137;271649;1336987;"2019-W30";30;2019-07-21;"2019";355786;1065338
2019-07-26;8171245;80289;261627;1347029;"2019-W30";30;2019-07-21;"2019";341916;1085402
2019-07-27;5090895;44361;169492;886861;"2019-W30";30;2019-07-21;"2019";213853;717369
2019-07-28;2881521;23746;96543;579663;"2019-W31";31;2019-07-28;"2019";120289;483120
2019-07-29;8023971;79584;270362;1340583;"2019-W31";31;2019-07-28;"2019";349946;1070221
2019-07-30;8123081;81905;265896;1339574;"2019-W31";31;2019-07-28;"2019";347801;1073678
2019-07-31;8087180;88395;273618;1342803;"2019-W31";31;2019-07-28;"2019";362013;1069185
2019-08-01;8649133;116044;457961;1414450;"2019-W31";31;2019-07-28;"2019";574005;956489
2019-08-02;8528220;125084;496575;1389924;"2019-W31";31;2019-07-28;"2019";621659;893349
2019-08-03;4855432;56357;282352;780624;"2019-W31";31;2019-07-28;"2019";338709;498272
2019-08-04;2549326;27239;148012;466092;"2019-W32";32;2019-08-04;"2019";175251;318080
2019-08-05;8353811;173790;666253;1312306;"2019-W32";32;2019-08-04;"2019";840043;646053
2019-08-06;8984189;194491;686951;1439143;"2019-W32";32;2019-08-04;"2019";881442;752192
2019-08-07;8841822;195276;701479;1446602;"2019-W32";32;2019-08-04;"2019";896755;745123
2019-08-08;9266924;209266;760392;1469187;"2019-W32";32;2019-08-04;"2019";969658;708795
2019-08-09;9094680;196953;722824;1444053;"2019-W32";32;2019-08-04;"2019";919777;721229
2019-08-10;5701224;85968;386834;954113;"2019-W32";32;2019-08-04;"2019";472802;567279
2019-08-11;3021811;34006;181931;572507;"2019-W33";33;2019-08-11;"2019";215937;390576
2019-08-12;8980770;224925;763303;1412064;"2019-W33";33;2019-08-11;"2019";988228;648761
2019-08-13;9029085;230541;772356;1385608;"2019-W33";33;2019-08-11;"2019";1002897;613252
2019-08-14;8776719;231095;796735;1269136;"2019-W33";33;2019-08-11;"2019";1027830;472401
2019-08-15;9102985;237079;823162;1386626;"2019-W33";33;2019-08-11;"2019";1060241;563464
2019-08-16;8840766;217390;776148;1357405;"2019-W33";33;2019-08-11;"2019";993538;581257
2019-08-17;5288601;85798;378652;886648;"2019-W33";33;2019-08-11;"2019";464450;507996
2019-08-18;2923408;42067;204609;574705;"2019-W34";34;2019-08-18;"2019";246676;370096
2019-08-19;7851336;205612;715261;1144339;"2019-W34";34;2019-08-18;"2019";920873;429078
2019-08-20;8895379;241741;841435;1314875;"2019-W34";34;2019-08-18;"2019";1083176;473440
2019-08-21;9065729;245381;850051;1399201;"2019-W34";34;2019-08-18;"2019";1095432;549150
2019-08-22;8906154;242206;834853;1337276;"2019-W34";34;2019-08-18;"2019";1077059;502423
2019-08-23;8690784;221548;777273;1314991;"2019-W34";34;2019-08-18;"2019";998821;537718
2019-08-24;5085057;83655;364200;839166;"2019-W34";34;2019-08-18;"2019";447855;474966
2019-08-25;2858671;40255;192068;553493;"2019-W35";35;2019-08-25;"2019";232323;361425
2019-08-26;8223703;222160;741856;1293889;"2019-W35";35;2019-08-25;"2019";964016;552033
2019-08-27;2830730;72239;237758;449961;"2019-W35";35;2019-08-25;"2019";309997;212203
2019-08-28;9014121;233601;777527;1448777;"2019-W35";35;2019-08-25;"2019";1011128;671250
2019-08-29;8932118;225435;735800;1405166;"2019-W35";35;2019-08-25;"2019";961235;669366
2019-08-30;8553853;196262;633967;1368697;"2019-W35";35;2019-08-25;"2019";830229;734730
2019-08-31;5352555;78687;310143;916186;"2019-W35";35;2019-08-25;"2019";388830;606043
2019-09-01;2607018;32589;162871;476037;"2019-W36";36;2019-09-01;"2019";195460;313166
2019-09-02;8465386;215023;790836;1293161;"2019-W36";36;2019-09-01;"2019";1005859;502325
2019-09-03;8897893;240199;853526;1398008;"2019-W36";36;2019-09-01;"2019";1093725;544482
2019-09-04;9061029;251392;879025;1446155;"2019-W36";36;2019-09-01;"2019";1130417;567130
2019-09-05;7790405;202150;726102;1222012;"2019-W36";36;2019-09-01;"2019";928252;495910
2019-09-06;7206513;161288;529598;1149397;"2019-W36";36;2019-09-01;"2019";690886;619799
2019-09-07;4423007;73249;306838;790140;"2019-W36";36;2019-09-01;"2019";380087;483302
2019-09-08;3095878;49001;216749;604706;"2019-W37";37;2019-09-08;"2019";265750;387957
2019-09-09;9143697;261254;843845;1504695;"2019-W37";37;2019-09-08;"2019";1105099;660850
2019-09-10;9320151;273954;885092;1492937;"2019-W37";37;2019-09-08;"2019";1159046;607845
2019-09-11;9237086;274394;884882;1470263;"2019-W37";37;2019-09-08;"2019";1159276;585381
2019-09-12;9099331;272659;884513;1401831;"2019-W37";37;2019-09-08;"2019";1157172;517318
2019-09-13;8957126;253361;838368;1399461;"2019-W37";37;2019-09-08;"2019";1091729;561093
2019-09-14;5507157;106708;429750;930065;"2019-W37";37;2019-09-08;"2019";536458;500315
2019-09-15;3054969;51831;232820;589217;"2019-W38";38;2019-09-15;"2019";284651;356397
2019-09-16;8849625;266431;876920;1381270;"2019-W38";38;2019-09-15;"2019";1143351;504350
2019-09-17;9086028;279057;907826;1404816;"2019-W38";38;2019-09-15;"2019";1186883;496990
2019-09-18;9087370;276974;904165;1411261;"2019-W38";38;2019-09-15;"2019";1181139;507096
2019-09-19;8999283;270454;887871;1368608;"2019-W38";38;2019-09-15;"2019";1158325;480737
2019-09-20;8654268;242474;828362;1329189;"2019-W38";38;2019-09-15;"2019";1070836;500827
2019-09-21;5172374;98551;406078;858253;"2019-W38";38;2019-09-15;"2019";504629;452175
2019-09-22;2698572;42422;194155;519849;"2019-W39";39;2019-09-22;"2019";236577;325694
2019-09-23;7976554;236079;781419;1215634;"2019-W39";39;2019-09-22;"2019";1017498;434215
2019-09-24;8970917;265046;858802;1396207;"2019-W39";39;2019-09-22;"2019";1123848;537405
2019-09-25;8850620;255611;820834;1357751;"2019-W39";39;2019-09-22;"2019";1076445;536917
2019-09-26;8830707;247102;791923;1340674;"2019-W39";39;2019-09-22;"2019";1039025;548751
2019-09-27;8721301;220151;705821;1373616;"2019-W39";39;2019-09-22;"2019";925972;667795
2019-09-28;5182423;86444;342564;867844;"2019-W39";39;2019-09-22;"2019";429008;525280
2019-09-29;2916232;41007;175791;576162;"2019-W40";40;2019-09-29;"2019";216798;400371
2019-09-30;8540682;211683;662832;1377965;"2019-W40";40;2019-09-29;"2019";874515;715133
2019-10-01;9238665;250156;855207;1495648;"2019-W40";40;2019-09-29;"2019";1105363;640441
2019-10-02;9302013;265564;885810;1507481;"2019-W40";40;2019-09-29;"2019";1151374;621671
2019-10-03;9273905;268233;876188;1491805;"2019-W40";40;2019-09-29;"2019";1144421;615617
2019-10-04;9215060;252572;829956;1499801;"2019-W40";40;2019-09-29;"2019";1082528;669845
2019-10-05;5745997;111985;454805;969718;"2019-W40";40;2019-09-29;"2019";566790;514913
2019-10-06;3100491;52083;207591;612488;"2019-W41";41;2019-10-06;"2019";259674;404897
2019-10-07;9111412;267532;795382;1501187;"2019-W41";41;2019-10-06;"2019";1062914;705805
2019-10-08;9188582;271902;831043;1456979;"2019-W41";41;2019-10-06;"2019";1102945;625936
2019-10-09;9271979;277184;825261;1489072;"2019-W41";41;2019-10-06;"2019";1102445;663811
2019-10-10;9429647;281935;850068;1502506;"2019-W41";41;2019-10-06;"2019";1132003;652438
2019-10-11;9195223;259444;787156;1467258;"2019-W41";41;2019-10-06;"2019";1046600;680102
2019-10-12;4509366;82722;341290;794040;"2019-W41";41;2019-10-06;"2019";424012;452750
2019-10-13;3126718;54505;234406;599084;"2019-W42";42;2019-10-13;"2019";288911;364678
2019-10-14;8496505;222854;643398;1392261;"2019-W42";42;2019-10-13;"2019";866252;748863
2019-10-15;8725891;238368;633481;1440709;"2019-W42";42;2019-10-13;"2019";871849;807228
2019-10-16;9273646;283930;885055;1487966;"2019-W42";42;2019-10-13;"2019";1168985;602911
2019-10-17;9213979;280863;884667;1439343;"2019-W42";42;2019-10-13;"2019";1165530;554676
2019-10-18;8844417;249336;788924;1376944;"2019-W42";42;2019-10-13;"2019";1038260;588020
2019-10-19;5439237;108904;438869;910659;"2019-W42";42;2019-10-13;"2019";547773;471790
2019-10-20;2989975;53628;229250;571466;"2019-W43";43;2019-10-20;"2019";282878;342216
2019-10-21;8312030;253338;811782;1310115;"2019-W43";43;2019-10-20;"2019";1065120;498333
2019-10-22;9087230;276043;891908;1438312;"2019-W43";43;2019-10-20;"2019";1167951;546404
2019-10-23;9104698;273667;878074;1444659;"2019-W43";43;2019-10-20;"2019";1151741;566585
2019-10-24;9010562;266482;857749;1401355;"2019-W43";43;2019-10-20;"2019";1124231;543606
2019-10-25;8931318;242774;789285;1421559;"2019-W43";43;2019-10-20;"2019";1032059;632274
2019-10-26;5368957;101202;388518;914223;"2019-W43";43;2019-10-20;"2019";489720;525705
2019-10-27;3014956;49600;208907;595192;"2019-W44";44;2019-10-27;"2019";258507;386285
2019-10-28;7921712;208514;516558;1275430;"2019-W44";44;2019-10-27;"2019";725072;758872
2019-10-29;8993896;247406;764647;1457671;"2019-W44";44;2019-10-27;"2019";1012053;693024
2019-10-30;9043067;237396;733820;1460821;"2019-W44";44;2019-10-27;"2019";971216;727001
2019-10-31;8987140;223961;676089;1438094;"2019-W44";44;2019-10-27;"2019";900050;762005
2019-11-01;8975138;222384;779575;1464068;"2019-W44";44;2019-10-27;"2019";1001959;684493
2019-11-02;4233002;70795;311684;801967;"2019-W44";44;2019-10-27;"2019";382479;490283
2019-11-03;3065960;53194;258385;589694;"2019-W45";45;2019-11-03;"2019";311579;331309
2019-11-04;8863149;258432;859986;1443167;"2019-W45";45;2019-11-03;"2019";1118418;583181
2019-11-05;8925098;263669;849359;1453180;"2019-W45";45;2019-11-03;"2019";1113028;603821
2019-11-06;9137042;280730;817898;1496025;"2019-W45";45;2019-11-03;"2019";1098628;678127
2019-11-07;9302310;283181;864643;1515666;"2019-W45";45;2019-11-03;"2019";1147824;651023
2019-11-08;9154502;266983;830101;1472196;"2019-W45";45;2019-11-03;"2019";1097084;642095
2019-11-09;5664348;116571;434995;963926;"2019-W45";45;2019-11-03;"2019";551566;528931
2019-11-10;3086199;58901;251879;590446;"2019-W46";46;2019-11-10;"2019";310780;338567
2019-11-11;9024271;277487;855291;1473177;"2019-W46";46;2019-11-10;"2019";1132778;617886
2019-11-12;9252732;291453;892455;1497593;"2019-W46";46;2019-11-10;"2019";1183908;605138
2019-11-13;9246862;292222;887231;1497157;"2019-W46";46;2019-11-10;"2019";1179453;609926
2019-11-14;8820825;261936;801053;1383166;"2019-W46";46;2019-11-10;"2019";1062989;582113
2019-11-15;3365609;57006;239277;551421;"2019-W46";46;2019-11-10;"2019";296283;312144
2019-11-16;4818319;84528;350280;883629;"2019-W46";46;2019-11-10;"2019";434808;533349
2019-11-17;2864005;48296;208811;576679;"2019-W47";47;2019-11-17;"2019";257107;367868
2019-11-18;8239704;254282;785954;1330757;"2019-W47";47;2019-11-17;"2019";1040236;544803
2019-11-19;7584930;232575;703082;1207938;"2019-W47";47;2019-11-17;"2019";935657;504856
2019-11-20;4051093;74625;297043;710674;"2019-W47";47;2019-11-17;"2019";371668;413631
2019-11-21;8604672;263053;815944;1368946;"2019-W47";47;2019-11-17;"2019";1078997;553002
2019-11-22;7436174;219137;670637;1144134;"2019-W47";47;2019-11-17;"2019";889774;473497
2019-11-23;3977239;78885;299371;658296;"2019-W47";47;2019-11-17;"2019";378256;358925
2019-11-24;2932514;53095;222614;585758;"2019-W48";48;2019-11-24;"2019";275709;363144
2019-11-25;8830052;252092;826150;1448151;"2019-W48";48;2019-11-24;"2019";1078242;622001
2019-11-26;9004351;253554;816702;1468299;"2019-W48";48;2019-11-24;"2019";1070256;651597
2019-11-27;8804850;240806;755227;1435051;"2019-W48";48;2019-11-24;"2019";996033;679824
2019-11-28;8523156;222219;710515;1290070;"2019-W48";48;2019-11-24;"2019";932734;579555
2019-11-29;8772979;211424;684013;1433178;"2019-W48";48;2019-11-24;"2019";895437;749165
2019-11-30;5356595;90612;335075;899488;"2019-W48";48;2019-11-24;"2019";425687;564413
2019-12-01;3225535;48635;218862;624695;"2019-W49";49;2019-12-01;"2019";267497;405833
2019-12-02;8757269;212752;728510;1453885;"2019-W49";49;2019-12-01;"2019";941262;725375
2019-12-03;9049424;231452;751123;1513686;"2019-W49";49;2019-12-01;"2019";982575;762563
2019-12-04;9013339;229717;736927;1513583;"2019-W49";49;2019-12-01;"2019";966644;776656
2019-12-05;8907609;223816;706023;1465531;"2019-W49";49;2019-12-01;"2019";929839;759508
2019-12-06;9021275;218094;620751;1527605;"2019-W49";49;2019-12-01;"2019";838845;906854
2019-12-07;6048570;116238;412017;1026372;"2019-W49";49;2019-12-01;"2019";528255;614355
2019-12-08;3459212;60802;234977;662810;"2019-W50";50;2019-12-08;"2019";295779;427833
2019-12-09;8618495;199131;577340;1450693;"2019-W50";50;2019-12-08;"2019";776471;873353
2019-12-10;8560406;194355;554002;1409789;"2019-W50";50;2019-12-08;"2019";748357;855787
2019-12-11;8736139;190371;556667;1473707;"2019-W50";50;2019-12-08;"2019";747038;917040
2019-12-12;8837765;186371;550495;1467147;"2019-W50";50;2019-12-08;"2019";736866;916652
2019-12-13;8602678;169778;512067;1407846;"2019-W50";50;2019-12-08;"2019";681845;895779
2019-12-14;5620676;90642;328293;945739;"2019-W50";50;2019-12-08;"2019";418935;617446
2019-12-15;3471378;53707;209437;653401;"2019-W51";51;2019-12-15;"2019";263144;443964
2019-12-16;8305187;142120;402535;1410090;"2019-W51";51;2019-12-15;"2019";544655;1007555
2019-12-17;8307725;136691;366212;1383920;"2019-W51";51;2019-12-15;"2019";502903;1017708
2019-12-18;8233877;128902;335829;1369306;"2019-W51";51;2019-12-15;"2019";464731;1033477
2019-12-19;8338943;124273;322410;1412306;"2019-W51";51;2019-12-15;"2019";446683;1089896
2019-12-20;8350798;116718;310128;1410908;"2019-W51";51;2019-12-15;"2019";426846;1100780
2019-12-21;5727563;70257;229005;966802;"2019-W51";51;2019-12-15;"2019";299262;737797
2019-12-22;3466812;38712;132837;655077;"2019-W52";52;2019-12-22;"2019";171549;522240
2019-12-23;6766161;75038;208558;1180090;"2019-W52";52;2019-12-22;"2019";283596;971532
2019-12-24;4549967;38732;132522;817165;"2019-W52";52;2019-12-22;"2019";171254;684643
2019-12-25;1714555;15402;55176;328212;"2019-W52";52;2019-12-22;"2019";70578;273036
2019-12-26;6064547;61977;150650;1060230;"2019-W52";52;2019-12-22;"2019";212627;909580
2019-12-27;6483142;62785;157469;1178538;"2019-W52";52;2019-12-22;"2019";220254;1021069
2019-12-28;4527820;38548;117088;849606;"2019-W52";52;2019-12-22;"2019";155636;732518
2019-12-29;2728983;21421;70356;571314;"2020-W01";1;2019-12-29;"2019";91777;500958
2019-12-30;5458108;42330;116958;1083989;"2020-W01";1;2019-12-29;"2019";159288;967031
2019-12-31;3307579;20247;67374;670880;"2020-W01";1;2019-12-29;"2019";87621;603506
2020-01-01;1510667;10425;33415;299007;"2020-W01";1;2019-12-29;"2020";43840;265592
2020-01-02;5180666;34152;75375;936811;"2020-W01";1;2019-12-29;"2020";109527;861436
2020-01-03;6041922;38774;91554;1142745;"2020-W01";1;2019-12-29;"2020";130328;1051191
2020-01-04;4094846;23324;66553;794387;"2020-W01";1;2019-12-29;"2020";89877;727834
2020-01-05;2470913;14239;41445;538064;"2020-W02";2;2020-01-05;"2020";55684;496619
2020-01-06;7231256;53099;83;1350266;"2020-W02";2;2020-01-05;"2020";53182;1350183
2020-01-07;7446019;51522;37;1353394;"2020-W02";2;2020-01-05;"2020";51559;1353357
2020-01-08;7406739;46202;175;1340312;"2020-W02";2;2020-01-05;"2020";46377;1340137
2020-01-09;7459897;43726;16;1315765;"2020-W02";2;2020-01-05;"2020";43742;1315749
2020-01-10;7557759;42578;31;1341271;"2020-W02";2;2020-01-05;"2020";42609;1341240
2020-01-11;4736997;22795;29;862284;"2020-W02";2;2020-01-05;"2020";22824;862255
2020-01-12;2583099;11020;13;542486;"2020-W03";3;2020-01-12;"2020";11033;542473
2020-01-13;7418355;40189;41;1314525;"2020-W03";3;2020-01-12;"2020";40230;1314484
2020-01-14;7642034;40382;34;1348610;"2020-W03";3;2020-01-12;"2020";40416;1348576
2020-01-15;7763874;39786;28;1358662;"2020-W03";3;2020-01-12;"2020";39814;1358634
2020-01-16;7429340;34596;60;1226881;"2020-W03";3;2020-01-12;"2020";34656;1226821
2020-01-17;7477716;32853;31;1266971;"2020-W03";3;2020-01-12;"2020";32884;1266940
2020-01-18;4755050;18914;22;869113;"2020-W03";3;2020-01-12;"2020";18936;869091
2020-01-19;2700074;9949;26;576296;"2020-W04";4;2020-01-19;"2020";9975;576270
2020-01-20;7624226;33704;48;1334673;"2020-W04";4;2020-01-19;"2020";33752;1334625
2020-01-21;7863389;35427;61;1360729;"2020-W04";4;2020-01-19;"2020";35488;1360668
2020-01-22;7842272;33954;44;1357060;"2020-W04";4;2020-01-19;"2020";33998;1357016
2020-01-23;7624370;30823;60;1251703;"2020-W04";4;2020-01-19;"2020";30883;1251643
2020-01-24;7577364;28476;52;1259485;"2020-W04";4;2020-01-19;"2020";28528;1259433
2020-01-25;4016035;14437;15;773709;"2020-W04";4;2020-01-19;"2020";14452;773694
2020-01-26;2788490;9128;20;600868;"2020-W05";5;2020-01-26;"2020";9148;600848
2020-01-27;7739098;34584;51;1356914;"2020-W05";5;2020-01-26;"2020";34635;1356863
2020-01-28;7870635;34742;65;1359242;"2020-W05";5;2020-01-26;"2020";34807;1359177
2020-01-29;7977046;34488;59;1392939;"2020-W05";5;2020-01-26;"2020";34547;1392880
2020-01-30;7828873;31973;71;1315768;"2020-W05";5;2020-01-26;"2020";32044;1315697
2020-01-31;7999590;31024;62;1385317;"2020-W05";5;2020-01-26;"2020";31086;1385255
2020-02-01;4781423;16590;34073;849025;"2020-W05";5;2020-01-26;"2020";50663;814952
2020-02-02;2668300;9463;25250;565091;"2020-W06";6;2020-02-02;"2020";34713;539841
2020-02-03;7823655;55056;138064;1283551;"2020-W06";6;2020-02-02;"2020";193120;1145487
2020-02-04;8357076;73619;184913;1425876;"2020-W06";6;2020-02-02;"2020";258532;1240963
2020-02-05;8589246;82491;216222;1489960;"2020-W06";6;2020-02-02;"2020";298713;1273738
2020-02-06;8570033;89597;258111;1454032;"2020-W06";6;2020-02-02;"2020";347708;1195921
2020-02-07;8673768;92770;290267;1502602;"2020-W06";6;2020-02-02;"2020";383037;1212335
2020-02-08;5317762;39892;144178;963127;"2020-W06";6;2020-02-02;"2020";184070;818949
2020-02-09;2900872;19600;78117;600743;"2020-W07";7;2020-02-09;"2020";97717;522626
2020-02-10;6294201;66618;233975;943153;"2020-W07";7;2020-02-09;"2020";300593;709178
2020-02-11;8398070;117316;380217;1376147;"2020-W07";7;2020-02-09;"2020";497533;995930
2020-02-12;8752441;134280;437587;1446736;"2020-W07";7;2020-02-09;"2020";571867;1009149
2020-02-13;8789529;138076;459881;1450273;"2020-W07";7;2020-02-09;"2020";597957;990392
2020-02-14;8714699;133530;455350;1445428;"2020-W07";7;2020-02-09;"2020";588880;990078
2020-02-15;5323304;56124;217118;934798;"2020-W07";7;2020-02-09;"2020";273242;717680
2020-02-16;3006815;30952;130147;593492;"2020-W08";8;2020-02-16;"2020";161099;463345
2020-02-17;8612053;155893;516573;1415124;"2020-W08";8;2020-02-16;"2020";672466;898551
2020-02-18;8845290;168345;543197;1436653;"2020-W08";8;2020-02-16;"2020";711542;893456
2020-02-19;8755119;168487;552444;1427281;"2020-W08";8;2020-02-16;"2020";720931;874837
2020-02-20;8818195;170295;563560;1409031;"2020-W08";8;2020-02-16;"2020";733855;845471
2020-02-21;8426560;145456;489448;1356304;"2020-W08";8;2020-02-16;"2020";634904;866856
2020-02-22;4576087;46140;205531;807926;"2020-W08";8;2020-02-16;"2020";251671;602395
2020-02-23;2705880;27579;126288;544931;"2020-W09";9;2020-02-23;"2020";153867;418643
2020-02-24;4379158;38393;170221;797969;"2020-W09";9;2020-02-23;"2020";208614;627748
2020-02-25;3139127;29647;138631;561313;"2020-W09";9;2020-02-23;"2020";168278;422682
2020-02-26;6346098;65782;242329;1037969;"2020-W09";9;2020-02-23;"2020";308111;795640
2020-02-27;8301713;150833;469419;1368021;"2020-W09";9;2020-02-23;"2020";620252;898602
2020-02-28;8331436;145740;453781;1390676;"2020-W09";9;2020-02-23;"2020";599521;936895
2020-02-29;4993574;57005;243517;887046;"2020-W09";9;2020-02-23;"2020";300522;643529
2020-03-01;2770588;28188;145684;565153;"2020-W10";10;2020-03-01;"2020";173872;419469
2020-03-02;8544188;181673;634225;1390860;"2020-W10";10;2020-03-01;"2020";815898;756635
2020-03-03;8696716;196388;600511;1425721;"2020-W10";10;2020-03-01;"2020";796899;825210
2020-03-04;8858633;199923;673427;1478787;"2020-W10";10;2020-03-01;"2020";873350;805360
2020-03-05;8836446;204535;678188;1454355;"2020-W10";10;2020-03-01;"2020";882723;776167
2020-03-06;8546742;188077;563924;1438137;"2020-W10";10;2020-03-01;"2020";752001;874213
2020-03-07;4918552;66533;267549;867007;"2020-W10";10;2020-03-01;"2020";334082;599458
2020-03-08;2895127;32728;151504;581054;"2020-W11";11;2020-03-08;"2020";184232;429550
2020-03-09;8831401;211507;674911;1466526;"2020-W11";11;2020-03-08;"2020";886418;791615
2020-03-10;9100311;223879;715822;1495415;"2020-W11";11;2020-03-08;"2020";939701;779593
2020-03-11;9082989;227059;722877;1491104;"2020-W11";11;2020-03-08;"2020";949936;768227
2020-03-12;8960759;223843;725606;1429716;"2020-W11";11;2020-03-08;"2020";949449;704110
2020-03-13;8651977;195676;684071;1378253;"2020-W11";11;2020-03-08;"2020";879747;694182
2020-03-14;4961557;65259;297111;857113;"2020-W11";11;2020-03-08;"2020";362370;560002
2020-03-15;2628658;29030;149648;522997;"2020-W12";12;2020-03-15;"2020";178678;373349
2020-03-16;7354644;116671;443584;1153320;"2020-W12";12;2020-03-15;"2020";560255;709736
2020-03-17;6648224;82469;326332;1011335;"2020-W12";12;2020-03-15;"2020";408801;685003
2020-03-18;6110833;67507;286364;905000;"2020-W12";12;2020-03-15;"2020";353871;618636
2020-03-19;5371313;52211;241386;748844;"2020-W12";12;2020-03-15;"2020";293597;507458
2020-03-20;4566894;40422;204477;615536;"2020-W12";12;2020-03-15;"2020";244899;411059
2020-03-21;2173891;13554;91851;310287;"2020-W12";12;2020-03-15;"2020";105405;218436
2020-03-22;1076847;6228;43520;166268;"2020-W13";13;2020-03-22;"2020";49748;122748
2020-03-23;2863364;19190;106978;378772;"2020-W13";13;2020-03-22;"2020";126168;271794
2020-03-24;2384210;14532;86060;297920;"2020-W13";13;2020-03-22;"2020";100592;211860
2020-03-25;2337923;12995;84854;297287;"2020-W13";13;2020-03-22;"2020";97849;212433
2020-03-26;2315474;12258;84612;294192;"2020-W13";13;2020-03-22;"2020";96870;209580
2020-03-27;2409535;12164;89801;316144;"2020-W13";13;2020-03-22;"2020";101965;226343
2020-03-28;1538247;6405;58916;216763;"2020-W13";13;2020-03-22;"2020";65321;157847
2020-03-29;857147;3500;32406;128180;"2020-W14";14;2020-03-29;"2020";35906;95774
2020-03-30;2391211;11177;84991;309569;"2020-W14";14;2020-03-29;"2020";96168;224578
2020-03-31;2291319;10272;80243;300997;"2020-W14";14;2020-03-29;"2020";90515;220754
2020-04-01;2517227;10732;83093;351766;"2020-W14";14;2020-03-29;"2020";93825;268673
2020-04-02;2454383;9813;77514;336751;"2020-W14";14;2020-03-29;"2020";87327;259237
2020-04-03;2515810;9722;78388;359041;"2020-W14";14;2020-03-29;"2020";88110;280653
2020-04-04;1649513;5676;52804;248273;"2020-W14";14;2020-03-29;"2020";58480;195469
2020-04-05;914782;3059;29654;148000;"2020-W15";15;2020-04-05;"2020";32713;118346
2020-04-06;2722928;11349;2076;405472;"2020-W15";15;2020-04-05;"2020";13425;403396
2020-04-07;2794639;10961;2321;420480;"2020-W15";15;2020-04-05;"2020";13282;418159
2020-04-08;2820536;10739;2361;414309;"2020-W15";15;2020-04-05;"2020";13100;411948
2020-04-09;2879819;10354;2334;425721;"2020-W15";15;2020-04-05;"2020";12688;423387
2020-04-10;1220652;4102;1213;180150;"2020-W15";15;2020-04-05;"2020";5315;178937
2020-04-11;1671681;5332;1429;262473;"2020-W15";15;2020-04-05;"2020";6761;261044
2020-04-12;949501;2992;938;152641;"2020-W16";16;2020-04-12;"2020";3930;151703
2020-04-13;2604735;8928;2422;369794;"2020-W16";16;2020-04-12;"2020";11350;367372
2020-04-14;2648567;8780;2522;365004;"2020-W16";16;2020-04-12;"2020";11302;362482
2020-04-15;2682644;8576;2690;371633;"2020-W16";16;2020-04-12;"2020";11266;368943
2020-04-16;2660944;8234;2726;364355;"2020-W16";16;2020-04-12;"2020";10960;361629
2020-04-17;2713702;8327;2767;374834;"2020-W16";16;2020-04-12;"2020";11094;372067
2020-04-18;1722826;4931;1780;263309;"2020-W16";16;2020-04-12;"2020";6711;261529
2020-04-19;921124;2497;1056;153767;"2020-W17";17;2020-04-19;"2020";3553;152711
2020-04-20;2204987;6262;2259;313038;"2020-W17";17;2020-04-19;"2020";8521;310779
2020-04-21;1239154;3220;1479;188762;"2020-W17";17;2020-04-19;"2020";4699;187283
2020-04-22;2779098;8505;3007;401135;"2020-W17";17;2020-04-19;"2020";11512;398128
2020-04-23;2808407;8255;3105;385279;"2020-W17";17;2020-04-19;"2020";11360;382174
2020-04-24;2866889;8393;3271;397054;"2020-W17";17;2020-04-19;"2020";11664;393783
2020-04-25;1810311;4923;1962;281776;"2020-W17";17;2020-04-19;"2020";6885;279814
2020-04-26;993701;2617;1130;170493;"2020-W18";18;2020-04-26;"2020";3747;169363
2020-04-27;2803251;8069;3020;399225;"2020-W18";18;2020-04-26;"2020";11089;396205
2020-04-28;2735039;7586;2904;383539;"2020-W18";18;2020-04-26;"2020";10490;380635
2020-04-29;2891524;7955;2941;406566;"2020-W18";18;2020-04-26;"2020";10896;403625
2020-04-30;2942421;7869;2921;422205;"2020-W18";18;2020-04-26;"2020";10790;419284
2020-05-01;1275036;3046;1128;198576;"2020-W18";18;2020-04-26;"2020";4174;197448
2020-05-02;1576874;3581;1328;256976;"2020-W18";18;2020-04-26;"2020";4909;255648
2020-05-03;933489;2111;759;159480;"2020-W19";19;2020-05-03;"2020";2870;158721
2020-05-04;2831649;7326;2029;410720;"2020-W19";19;2020-05-03;"2020";9355;408691
2020-05-05;2827902;7285;1750;417104;"2020-W19";19;2020-05-03;"2020";9035;415354
2020-05-06;2874905;7028;554;426934;"2020-W19";19;2020-05-03;"2020";7582;426380
2020-05-07;2884440;6799;543;404867;"2020-W19";19;2020-05-03;"2020";7342;404324
2020-05-08;2997205;7203;721;455630;"2020-W19";19;2020-05-03;"2020";7924;454909
2020-05-09;1803278;4043;489;284126;"2020-W19";19;2020-05-03;"2020";4532;283637
2020-05-10;1006182;2116;373;166660;"2020-W20";20;2020-05-10;"2020";2489;166287
2020-05-11;3039474;8196;1335;424473;"2020-W20";20;2020-05-10;"2020";9531;423138
2020-05-14;2965057;7210;2110;378249;"2020-W20";20;2020-05-10;"2020";9320;376139
2020-05-15;2932297;7246;2115;382683;"2020-W20";20;2020-05-10;"2020";9361;380568
2020-05-16;1741926;3775;1295;266702;"2020-W20";20;2020-05-10;"2020";5070;265407
2020-05-17;1043689;2252;792;171404;"2020-W21";21;2020-05-17;"2020";3044;170612
2020-05-18;2760024;6067;2237;373940;"2020-W21";21;2020-05-17;"2020";8304;371703
2020-05-19;2698718;6008;2268;377903;"2020-W21";21;2020-05-17;"2020";8276;375635
2020-05-20;1931412;3969;1755;281311;"2020-W21";21;2020-05-17;"2020";5724;279556
2020-05-21;2013330;3954;1966;298213;"2020-W21";21;2020-05-17;"2020";5920;296247
2020-05-22;2467037;4912;2313;335517;"2020-W21";21;2020-05-17;"2020";7225;333204
2020-05-23;1456775;2692;1279;212734;"2020-W21";21;2020-05-17;"2020";3971;211455
2020-05-24;806517;1467;740;133646;"2020-W22";22;2020-05-24;"2020";2207;132906
2020-05-25;1748529;3508;1833;268619;"2020-W22";22;2020-05-24;"2020";5341;266786
2020-05-26;2961194;6225;2875;429184;"2020-W22";22;2020-05-24;"2020";9100;426309
2020-05-27;2667823;5566;2693;377347;"2020-W22";22;2020-05-24;"2020";8259;374654
2020-05-28;2879608;5763;2984;395549;"2020-W22";22;2020-05-24;"2020";8747;392565
2020-05-29;2886639;5955;3118;415555;"2020-W22";22;2020-05-24;"2020";9073;412437
2020-05-30;1767051;3353;1675;278710;"2020-W22";22;2020-05-24;"2020";5028;277035
2020-05-31;966963;1767;1018;172010;"2020-W23";23;2020-05-31;"2020";2785;170992
2020-06-01;2848449;6020;3005;425011;"2020-W23";23;2020-05-31;"2020";9025;422006
2020-06-02;2629878;5492;3031;368439;"2020-W23";23;2020-05-31;"2020";8523;365408
2020-06-03;2962988;6228;3318;441195;"2020-W23";23;2020-05-31;"2020";9546;437877
2020-06-04;3071946;6397;3533;447622;"2020-W23";23;2020-05-31;"2020";9930;444089
2020-06-05;3131283;6534;3521;472373;"2020-W23";23;2020-05-31;"2020";10055;468852
2020-06-06;1922183;3799;1202;302568;"2020-W23";23;2020-05-31;"2020";5001;301366
2020-06-07;1074342;2060;775;188595;"2020-W24";24;2020-06-07;"2020";2835;187820
2020-06-08;3188798;6717;2710;484847;"2020-W24";24;2020-06-07;"2020";9427;482137
2020-06-09;3294643;7023;3074;483592;"2020-W24";24;2020-06-07;"2020";10097;480518
2020-06-10;3336944;7435;3429;498862;"2020-W24";24;2020-06-07;"2020";10864;495433
2020-06-11;3110854;6695;3291;425631;"2020-W24";24;2020-06-07;"2020";9986;422340
2020-06-12;3379818;7419;3570;491798;"2020-W24";24;2020-06-07;"2020";10989;488228
2020-06-13;2086799;4283;2051;331505;"2020-W24";24;2020-06-07;"2020";6334;329454
2020-06-14;982507;1801;1060;163073;"2020-W25";25;2020-06-14;"2020";2861;162013
2020-06-15;3515499;7709;3949;521106;"2020-W25";25;2020-06-14;"2020";11658;517157
2020-06-16;3423010;7687;4145;495739;"2020-W25";25;2020-06-14;"2020";11832;491594
2020-06-17;3530673;7767;4404;518340;"2020-W25";25;2020-06-14;"2020";12171;513936
2020-06-18;3667432;7732;4436;523876;"2020-W25";25;2020-06-14;"2020";12168;519440
2020-06-19;3718007;7995;4620;532752;"2020-W25";25;2020-06-14;"2020";12615;528132
2020-06-20;2431081;5141;2698;378182;"2020-W25";25;2020-06-14;"2020";7839;375484
2020-06-21;1196658;2320;1380;211366;"2020-W26";26;2020-06-21;"2020";3700;209986
2020-06-22;3710878;8033;4741;537913;"2020-W26";26;2020-06-21;"2020";12774;533172
2020-06-23;3739365;8087;4879;537829;"2020-W26";26;2020-06-21;"2020";12966;532950
2020-06-24;3728835;8033;4810;543695;"2020-W26";26;2020-06-21;"2020";12843;538885
2020-06-25;3553374;7409;4598;504434;"2020-W26";26;2020-06-21;"2020";12007;499836
2020-06-26;3126846;6208;4051;428166;"2020-W26";26;2020-06-21;"2020";10259;424115
2020-06-27;1984182;3181;2492;256698;"2020-W26";26;2020-06-21;"2020";5673;254206
2020-06-28;1209360;2132;1447;215136;"2020-W27";27;2020-06-28;"2020";3579;213689
2020-06-29;3706191;7557;4804;549476;"2020-W27";27;2020-06-28;"2020";12361;544672
2020-06-30;3727818;8030;4924;553068;"2020-W27";27;2020-06-28;"2020";12954;548144
2020-07-01;3308043;6887;4077;484153;"2020-W27";27;2020-06-28;"2020";10964;480076
2020-07-02;3966546;8039;4876;584132;"2020-W27";27;2020-06-28;"2020";12915;579256
2020-07-03;4022215;8007;4752;602466;"2020-W27";27;2020-06-28;"2020";12759;597714
2020-07-04;2647966;5206;2843;416313;"2020-W27";27;2020-06-28;"2020";8049;413470
2020-07-05;1286094;2201;1340;228708;"2020-W28";28;2020-07-05;"2020";3541;227368
2020-07-06;3629298;7236;1080;556562;"2020-W28";28;2020-07-05;"2020";8316;555482
2020-07-07;4239045;8479;1583;659542;"2020-W28";28;2020-07-05;"2020";10062;657959
2020-07-08;4165348;8314;1633;641547;"2020-W28";28;2020-07-05;"2020";9947;639914
2020-07-09;3679026;7069;1456;537756;"2020-W28";28;2020-07-05;"2020";8525;536300
2020-07-10;4306885;8343;1750;645715;"2020-W28";28;2020-07-05;"2020";10093;643965
2020-07-11;2860649;5464;956;447350;"2020-W28";28;2020-07-05;"2020";6420;446394
2020-07-12;1436755;2293;492;259219;"2020-W29";29;2020-07-12;"2020";2785;258727
2020-07-13;4174944;8142;1847;623494;"2020-W29";29;2020-07-12;"2020";9989;621647
2020-07-14;4157984;7958;1859;599426;"2020-W29";29;2020-07-12;"2020";9817;597567
2020-07-15;4167423;7726;1820;596882;"2020-W29";29;2020-07-12;"2020";9546;595062
2020-07-16;4109661;7576;1802;576982;"2020-W29";29;2020-07-12;"2020";9378;575180
2020-07-17;3997783;7431;1629;571364;"2020-W29";29;2020-07-12;"2020";9060;569735
2020-07-18;2504005;4745;796;383870;"2020-W29";29;2020-07-12;"2020";5541;383074
2020-07-19;1145010;1843;380;201284;"2020-W30";30;2020-07-19;"2020";2223;200904
2020-07-20;4207078;7790;1716;627292;"2020-W30";30;2020-07-19;"2020";9506;625576
2020-07-21;4237484;7791;1977;621213;"2020-W30";30;2020-07-19;"2020";9768;619236
2020-07-22;3936975;7266;1718;577792;"2020-W30";30;2020-07-19;"2020";8984;576074
2020-07-23;3420040;6224;1504;477372;"2020-W30";30;2020-07-19;"2020";7728;475868
2020-07-24;4288127;7992;1649;624932;"2020-W30";30;2020-07-19;"2020";9641;623283
2020-07-25;2806502;5081;870;435973;"2020-W30";30;2020-07-19;"2020";5951;435103
2020-07-26;1358179;2061;491;241462;"2020-W31";31;2020-07-26;"2020";2552;240971
2020-07-27;3868109;7002;1724;570923;"2020-W31";31;2020-07-26;"2020";8726;569199
2020-07-28;3493540;6142;1424;504090;"2020-W31";31;2020-07-26;"2020";7566;502666
2020-07-29;4372542;7633;1953;633581;"2020-W31";31;2020-07-26;"2020";9586;631628
2020-07-30;4276391;7095;1884;592238;"2020-W31";31;2020-07-26;"2020";8979;590354
2020-07-31;4508478;7658;1859;662308;"2020-W31";31;2020-07-26;"2020";9517;660449
2020-08-01;3019081;5407;1107;476025;"2020-W31";31;2020-07-26;"2020";6514;474918
2020-08-02;1505273;2249;673;273137;"2020-W32";32;2020-08-02;"2020";2922;272464
2020-08-03;4486146;8358;3012;687019;"2020-W32";32;2020-08-02;"2020";11370;684007
2020-08-04;4589812;8939;3578;704084;"2020-W32";32;2020-08-02;"2020";12517;700506
2020-08-05;4660151;9148;3907;724907;"2020-W32";32;2020-08-02;"2020";13055;721000
2020-08-06;4660427;8923;3410;707992;"2020-W32";32;2020-08-02;"2020";12333;704582
2020-08-07;4791166;9511;3467;749533;"2020-W32";32;2020-08-02;"2020";12978;746066
2020-08-08;3134060;6019;1867;491419;"2020-W32";32;2020-08-02;"2020";7886;489552
2020-08-09;1538652;2331;911;266762;"2020-W33";33;2020-08-09;"2020";3242;265851
2020-08-10;3839559;7368;3323;587902;"2020-W33";33;2020-08-09;"2020";10691;584579
2020-08-11;4711379;9200;4624;713421;"2020-W33";33;2020-08-09;"2020";13824;708797
2020-08-12;4743058;9258;4824;714749;"2020-W33";33;2020-08-09;"2020";14082;709925
2020-08-13;4684372;8905;4970;684785;"2020-W33";33;2020-08-09;"2020";13875;679815
2020-08-14;4733920;9162;5162;695271;"2020-W33";33;2020-08-09;"2020";14324;690109
2020-08-15;3027193;5531;2466;463629;"2020-W33";33;2020-08-09;"2020";7997;461163
2020-08-16;1350459;1964;1110;222058;"2020-W34";34;2020-08-16;"2020";3074;220948
2020-08-17;4410008;8404;5273;632293;"2020-W34";34;2020-08-16;"2020";13677;627020
2020-08-18;4412388;8200;5849;600617;"2020-W34";34;2020-08-16;"2020";14049;594768
2020-08-19;4627530;8933;5956;677339;"2020-W34";34;2020-08-16;"2020";14889;671383
2020-08-20;4422010;8238;6101;592777;"2020-W34";34;2020-08-16;"2020";14339;586676
2020-08-21;3920097;6437;5129;462166;"2020-W34";34;2020-08-16;"2020";11566;457037
2020-08-22;2567645;4062;2681;368959;"2020-W34";34;2020-08-16;"2020";6743;366278
2020-08-23;1251139;1827;1320;216611;"2020-W35";35;2020-08-23;"2020";3147;215291
2020-08-24;4618565;8853;7057;678629;"2020-W35";35;2020-08-23;"2020";15910;671572
2020-08-25;4714093;9334;7628;689142;"2020-W35";35;2020-08-23;"2020";16962;681514
2020-08-26;4777307;9571;7978;710350;"2020-W35";35;2020-08-23;"2020";17549;702372
2020-08-27;4714012;9538;8196;685736;"2020-W35";35;2020-08-23;"2020";17734;677540
2020-08-28;4714751;9161;7852;700803;"2020-W35";35;2020-08-23;"2020";17013;692951
2020-08-29;2859715;5703;3655;445246;"2020-W35";35;2020-08-23;"2020";9358;441591
2020-08-30;1354539;2186;1600;242317;"2020-W36";36;2020-08-30;"2020";3786;240717
2020-08-31;4463158;8747;7686;668033;"2020-W36";36;2020-08-30;"2020";16433;660347
2020-09-01;4701021;9503;8969;710259;"2020-W36";36;2020-08-30;"2020";18472;701290
2020-09-02;4612018;9845;9260;713894;"2020-W36";36;2020-08-30;"2020";19105;704634
2020-09-03;4151515;8635;8162;621946;"2020-W36";36;2020-08-30;"2020";16797;613784
2020-09-04;4807207;10066;9204;735669;"2020-W36";36;2020-08-30;"2020";19270;726465
2020-09-05;3070963;5928;4492;490867;"2020-W36";36;2020-08-30;"2020";10420;486375
2020-09-06;1498316;2532;1347;267800;"2020-W37";37;2020-09-06;"2020";3879;266453
2020-09-07;1611537;2710;1717;259596;"2020-W37";37;2020-09-06;"2020";4427;257879
2020-09-08;4965623;10686;8859;798943;"2020-W37";37;2020-09-06;"2020";19545;790084
2020-09-09;4856012;10782;9817;752177;"2020-W37";37;2020-09-06;"2020";20599;742360
2020-09-10;4753746;10618;9674;711160;"2020-W37";37;2020-09-06;"2020";20292;701486
2020-09-11;4581957;10337;9286;676050;"2020-W37";37;2020-09-06;"2020";19623;666764
2020-09-12;2795901;5567;4189;428156;"2020-W37";37;2020-09-06;"2020";9756;423967
2020-09-13;1318945;2255;1795;234176;"2020-W38";38;2020-09-13;"2020";4050;232381
2020-09-14;4683598;10350;10546;705400;"2020-W38";38;2020-09-13;"2020";20896;694854
2020-09-15;4663687;10920;11437;700016;"2020-W38";38;2020-09-13;"2020";22357;688579
2020-09-16;4244459;10293;10339;633235;"2020-W38";38;2020-09-13;"2020";20632;622896
2020-09-17;4891530;11683;12022;712095;"2020-W38";38;2020-09-13;"2020";23705;700073
2020-09-18;4712855;10983;11742;688703;"2020-W38";38;2020-09-13;"2020";22725;676961
2020-09-19;2998308;6372;5520;463608;"2020-W38";38;2020-09-13;"2020";11892;458088
2020-09-20;1344642;2289;2302;236929;"2020-W39";39;2020-09-20;"2020";4591;234627
2020-09-21;4731631;10763;12213;679026;"2020-W39";39;2020-09-20;"2020";22976;666813
2020-09-22;4658946;11100;13021;638695;"2020-W39";39;2020-09-20;"2020";24121;625674
2020-09-23;4923559;11679;13555;724487;"2020-W39";39;2020-09-20;"2020";25234;710932
2020-09-24;4930673;11998;13779;719026;"2020-W39";39;2020-09-20;"2020";25777;705247
2020-09-25;4928725;11662;13750;737067;"2020-W39";39;2020-09-20;"2020";25412;723317
2020-09-26;3045746;6531;6287;478925;"2020-W39";39;2020-09-20;"2020";12818;472638
2020-09-27;1474414;2719;3004;268002;"2020-W40";40;2020-09-27;"2020";5723;264998
2020-09-28;4672793;10993;13163;694281;"2020-W40";40;2020-09-27;"2020";24156;681118
2020-09-29;4827732;11697;14313;730450;"2020-W40";40;2020-09-27;"2020";26010;716137
2020-09-30;4495978;11065;13189;682810;"2020-W40";40;2020-09-27;"2020";24254;669621
2020-10-01;5180279;12627;15426;775915;"2020-W40";40;2020-09-27;"2020";28053;760489
2020-10-01;5065637;12311;14911;757123;"2020-W40";40;2020-09-27;"2020";27222;742212
2020-10-02;5198772;12879;15455;781434;"2020-W40";40;2020-09-27;"2020";28334;765979
2020-10-02;4978276;12320;14686;746182;"2020-W40";40;2020-09-27;"2020";27006;731496
2020-10-03;3151391;7079;7298;504400;"2020-W40";40;2020-09-27;"2020";14377;497102
2020-10-04;1448538;2798;3037;266677;"2020-W41";41;2020-10-04;"2020";5835;263640
2020-10-05;5065203;12583;15361;794129;"2020-W41";41;2020-10-04;"2020";27944;778768
2020-10-06;5172211;13769;12985;801837;"2020-W41";41;2020-10-04;"2020";26754;788852
2020-10-07;5128421;14355;15267;814057;"2020-W41";41;2020-10-04;"2020";29622;798790
2020-10-08;4523191;12390;13594;675396;"2020-W41";41;2020-10-04;"2020";25984;661802
2020-10-09;4637736;11468;14212;626372;"2020-W41";41;2020-10-04;"2020";25680;612160
2020-10-10;3468225;8185;8285;575980;"2020-W41";41;2020-10-04;"2020";16470;567695
2020-10-11;1770069;3514;3969;328282;"2020-W42";42;2020-10-11;"2020";7483;324313
2020-10-12;1947252;4052;4572;329569;"2020-W42";42;2020-10-11;"2020";8624;324997
2020-10-13;4626161;12953;15246;736558;"2020-W42";42;2020-10-11;"2020";28199;721312
2020-10-14;5297477;16070;18688;821758;"2020-W42";42;2020-10-11;"2020";34758;803070
2020-10-15;4857464;13801;16616;723276;"2020-W42";42;2020-10-11;"2020";30417;706660
2020-10-16;4751045;13879;16557;701630;"2020-W42";42;2020-10-11;"2020";30436;685073
2020-10-17;2948095;7297;8214;472779;"2020-W42";42;2020-10-11;"2020";15511;464565
2020-10-18;1309600;2869;3435;241252;"2020-W43";43;2020-10-18;"2020";6304;237817
2020-10-19;4907309;14612;17728;744806;"2020-W43";43;2020-10-18;"2020";32340;727078
2020-10-20;5016366;15778;19539;751926;"2020-W43";43;2020-10-18;"2020";35317;732387
2020-10-21;5028479;16081;20201;769196;"2020-W43";43;2020-10-18;"2020";36282;748995
2020-10-22;4473285;13881;17756;672005;"2020-W43";43;2020-10-18;"2020";31637;654249
2020-10-23;5234302;16087;20817;796750;"2020-W43";43;2020-10-18;"2020";36904;775933
2020-10-24;3277971;8359;10151;525830;"2020-W43";43;2020-10-18;"2020";18510;515679
2020-10-25;1540253;3275;4527;280362;"2020-W44";44;2020-10-25;"2020";7802;275835
2020-10-26;4131643;12619;15922;632367;"2020-W44";44;2020-10-25;"2020";28541;616445
2020-10-27;5291127;16963;23055;816740;"2020-W44";44;2020-10-25;"2020";40018;793685
2020-10-28;5276760;16769;22446;820705;"2020-W44";44;2020-10-25;"2020";39215;798259
2020-10-29;5263373;16268;22538;799000;"2020-W44";44;2020-10-25;"2020";38806;776462
2020-10-30;4656346;12645;17316;625837;"2020-W44";44;2020-10-25;"2020";29961;608521
2020-10-31;3129964;7500;9519;498199;"2020-W44";44;2020-10-25;"2020";17019;488680
2020-11-03;5391141;16966;24207;874784;"2020-W45";45;2020-11-01;"2020";41173;850577
2020-11-04;5329422;18028;25779;862931;"2020-W45";45;2020-11-01;"2020";43807;837152
2020-11-05;4790981;16481;26378;739325;"2020-W45";45;2020-11-01;"2020";42859;712947
2020-11-06;5190881;17533;26967;834804;"2020-W45";45;2020-11-01;"2020";44500;807837
2020-11-07;3299853;9894;21603;535009;"2020-W45";45;2020-11-01;"2020";31497;513406
2020-11-08;1565386;4283;11726;286894;"2020-W46";46;2020-11-08;"2020";16009;275168
2020-11-09;5306448;18957;42549;867698;"2020-W46";46;2020-11-08;"2020";61506;825149
2020-11-10;5298598;19835;48455;840200;"2020-W46";46;2020-11-08;"2020";68290;791745
2020-11-11;4534046;17365;44093;693020;"2020-W46";46;2020-11-08;"2020";61458;648927
2020-11-12;5216356;20109;54507;792993;"2020-W46";46;2020-11-08;"2020";74616;738486
2020-11-13;4933758;18435;52950;743384;"2020-W46";46;2020-11-08;"2020";71385;690434
2020-11-14;3191374;10515;38164;504613;"2020-W46";46;2020-11-08;"2020";48679;466449
2020-11-15;2102970;6169;22425;426579;"2020-W47";47;2020-11-15;"2020";28594;404154
2020-11-16;5264226;20118;62499;807634;"2020-W47";47;2020-11-15;"2020";82617;745135
2020-11-17;5282552;20729;65600;785242;"2020-W47";47;2020-11-15;"2020";86329;719642
2020-11-18;5280833;20565;65872;785670;"2020-W47";47;2020-11-15;"2020";86437;719798
2020-11-19;5089728;19190;64688;712605;"2020-W47";47;2020-11-15;"2020";83878;647917
2020-11-20;4847117;17504;62617;735784;"2020-W47";47;2020-11-15;"2020";80121;673167
2020-11-21;3421639;10936;46639;540812;"2020-W47";47;2020-11-15;"2020";57575;494173
2020-11-22;1726676;5060;24235;312154;"2020-W48";48;2020-11-22;"2020";29295;287919
2020-11-23;4332535;15730;53066;661030;"2020-W48";48;2020-11-22;"2020";68796;607964
2020-11-24;5523932;20829;70961;854694;"2020-W48";48;2020-11-22;"2020";91790;783733
2020-11-25;5566013;21113;72391;862220;"2020-W48";48;2020-11-22;"2020";93504;789829
2020-11-26;5451624;20264;69027;810944;"2020-W48";48;2020-11-22;"2020";89291;741917
2020-11-27;5619413;20578;72721;875163;"2020-W48";48;2020-11-22;"2020";93299;802442
2020-11-28;3683839;11916;50863;582273;"2020-W48";48;2020-11-22;"2020";62779;531410
2020-11-29;2530097;6864;30597;521674;"2020-W49";49;2020-11-29;"2020";37461;491077
2020-11-30;4359526;14562;50222;662100;"2020-W49";49;2020-11-29;"2020";64784;611878
2020-12-01;5507887;20213;64968;850923;"2020-W49";49;2020-11-29;"2020";85181;785955
2020-12-02;5629872;21913;74946;883711;"2020-W49";49;2020-11-29;"2020";96859;808765
2020-12-03;5582691;22145;78611;859590;"2020-W49";49;2020-11-29;"2020";100756;780979
2020-12-04;5560847;22291;82222;870416;"2020-W49";49;2020-11-29;"2020";104513;788194
2020-12-05;3746372;13284;60668;581460;"2020-W49";49;2020-11-29;"2020";73952;520792
2020-12-06;1826028;5765;21647;323223;"2020-W50";50;2020-12-06;"2020";27412;301576
2020-12-07;4368787;17506;48655;698264;"2020-W50";50;2020-12-06;"2020";66161;649609
2020-12-08;5561861;23169;71042;856269;"2020-W50";50;2020-12-06;"2020";94211;785227
2020-12-09;5707358;24262;77978;889959;"2020-W50";50;2020-12-06;"2020";102240;811981
2020-12-10;5669909;23318;79357;866240;"2020-W50";50;2020-12-06;"2020";102675;786883
2020-12-11;5596839;22463;80525;842626;"2020-W50";50;2020-12-06;"2020";102988;762101
2020-12-12;3798918;13530;59862;583271;"2020-W50";50;2020-12-06;"2020";73392;523409
2020-12-13;1902429;5995;29837;332750;"2020-W51";51;2020-12-13;"2020";35832;302913
2020-12-14;4779856;18020;66668;730383;"2020-W51";51;2020-12-13;"2020";84688;663715
2020-12-15;5683437;21397;79327;865374;"2020-W51";51;2020-12-13;"2020";100724;786047
2020-12-16;5698452;21191;79644;862202;"2020-W51";51;2020-12-13;"2020";100835;782558
2020-12-17;5651737;20098;74887;848187;"2020-W51";51;2020-12-13;"2020";94985;773300
2020-12-18;5534629;18771;71487;816873;"2020-W51";51;2020-12-13;"2020";90258;745386
2020-12-19;3894479;11974;55533;590575;"2020-W51";51;2020-12-13;"2020";67507;535042
2020-12-20;2067460;5509;29247;346339;"2020-W52";52;2020-12-20;"2020";34756;317092
2020-12-21;4654705;13944;52969;701882;"2020-W52";52;2020-12-20;"2020";66913;648913
2020-12-22;5381104;15612;60202;821701;"2020-W52";52;2020-12-20;"2020";75814;761499
2020-12-23;5076645;13598;57121;799747;"2020-W52";52;2020-12-20;"2020";70719;742626
2020-12-24;2656643;5130;27630;420756;"2020-W52";52;2020-12-20;"2020";32760;393126
2020-12-25;727090;1491;8643;127861;"2020-W52";52;2020-12-20;"2020";10134;119218
2020-12-26;2158471;3734;19780;391066;"2020-W52";52;2020-12-20;"2020";23514;371286
2020-12-27;1396587;2415;13625;263503;"2020-W53";53;2020-12-27;"2020";16040;249878
2020-12-28;4443762;9721;36489;731747;"2020-W53";53;2020-12-27;"2020";46210;695258
2020-12-29;4461368;9574;35926;731181;"2020-W53";53;2020-12-27;"2020";45500;695255
2020-12-30;4466179;8915;37623;756008;"2020-W53";53;2020-12-27;"2020";46538;718385
2020-12-31;2584025;4043;21423;459586;"2020-W53";53;2020-12-27;"2020";25466;438163
2021-01-01;877454;1514;8017;157636;"2020-W53";53;2020-12-27;"2021";9531;149619
2021-01-02;1815828;2431;11896;347793;"2020-W53";53;2020-12-27;"2021";14327;335897
2021-01-03;1386627;2110;10695;275949;"2021-W01";1;2021-01-03;"2021";12805;265254
2021-01-04;4432888;8629;26875;720161;"2021-W01";1;2021-01-03;"2021";35504;693286
2021-01-05;4158465;7865;24433;678718;"2021-W01";1;2021-01-03;"2021";32298;654285
2021-01-06;4922912;9073;30;793427;"2021-W01";1;2021-01-03;"2021";9103;793397
2021-01-07;4949754;8515;4;792247;"2021-W01";1;2021-01-03;"2021";8519;792243
2021-01-08;4968541;8045;1;818716;"2021-W01";1;2021-01-03;"2021";8046;818715
2021-01-09;2941804;4539;0;491535;"2021-W01";1;2021-01-03;"2021";4539;491535
2021-01-10;1401686;2188;1;259551;"2021-W02";2;2021-01-10;"2021";2189;259550
2021-01-11;5118953;8525;2;822759;"2021-W02";2;2021-01-10;"2021";8527;822757
2021-01-12;5096949;8278;0;777283;"2021-W02";2;2021-01-10;"2021";8278;777283
2021-01-13;5181183;8408;1;806464;"2021-W02";2;2021-01-10;"2021";8409;806463
2021-01-14;5058884;7645;2;758933;"2021-W02";2;2021-01-10;"2021";7647;758931
2021-01-15;4791791;6593;2;705087;"2021-W02";2;2021-01-10;"2021";6595;705085
2021-01-16;3006092;4307;2;489403;"2021-W02";2;2021-01-10;"2021";4309;489401
2021-01-17;1519170;2561;4;278073;"2021-W03";3;2021-01-17;"2021";2565;278069
2021-01-18;5090765;7701;3;779433;"2021-W03";3;2021-01-17;"2021";7704;779430
2021-01-19;5175056;7619;4;774252;"2021-W03";3;2021-01-17;"2021";7623;774248
2021-01-20;5241774;7698;8;802356;"2021-W03";3;2021-01-17;"2021";7706;802348
2021-01-21;5062544;7143;4;747413;"2021-W03";3;2021-01-17;"2021";7147;747409
2021-01-22;4646416;6412;4;703003;"2021-W03";3;2021-01-17;"2021";6416;702999
2021-01-23;2521529;3128;2;411773;"2021-W03";3;2021-01-17;"2021";3130;411771
2021-01-24;1803955;2466;2;328181;"2021-W04";4;2021-01-24;"2021";2468;328179
2021-01-25;2136143;2126;2;356379;"2021-W04";4;2021-01-24;"2021";2128;356377
2021-01-26;5326438;7035;4;836957;"2021-W04";4;2021-01-24;"2021";7039;836953
2021-01-27;5327211;6969;4;826149;"2021-W04";4;2021-01-24;"2021";6973;826145
2021-01-28;5219995;6698;121;790614;"2021-W04";4;2021-01-24;"2021";6819;790493
2021-01-29;5196141;6741;201;805705;"2021-W04";4;2021-01-24;"2021";6942;805504
2021-01-30;2690144;2688;74;460490;"2021-W04";4;2021-01-24;"2021";2762;460416
2021-01-31;1396445;1330;65;280519;"2021-W05";5;2021-01-31;"2021";1395;280454
2021-02-01;5151579;7456;682;707213;"2021-W05";5;2021-01-31;"2021";8138;706531
2021-02-02;5168374;7905;1058;629124;"2021-W05";5;2021-01-31;"2021";8963;628066
2021-02-03;5118499;8352;1335;601911;"2021-W05";5;2021-01-31;"2021";9687;600576
2021-02-04;4467649;7536;3254;511141;"2021-W05";5;2021-01-31;"2021";10790;507887
2021-02-05;5529421;9390;6613;657085;"2021-W05";5;2021-01-31;"2021";16003;650472
2021-02-06;3484653;4869;5321;437865;"2021-W05";5;2021-01-31;"2021";10190;432544
2021-02-07;1776836;2173;2975;261233;"2021-W06";6;2021-02-07;"2021";5148;258258
2021-02-08;5456268;11150;13988;644478;"2021-W06";6;2021-02-07;"2021";25138;630490
2021-02-09;5538626;12057;17396;637707;"2021-W06";6;2021-02-07;"2021";29453;620311
2021-02-10;5464171;12468;20245;618984;"2021-W06";6;2021-02-07;"2021";32713;598739
2021-02-11;5045886;11811;20808;533745;"2021-W06";6;2021-02-07;"2021";32619;512937
2021-02-12;4664591;10608;21492;518662;"2021-W06";6;2021-02-07;"2021";32100;497170
2021-02-13;3182266;4993;14068;360439;"2021-W06";6;2021-02-07;"2021";19061;346371
2021-02-14;1784034;2756;8433;262867;"2021-W07";7;2021-02-14;"2021";11189;254434
2021-02-15;4932345;10576;29394;556296;"2021-W07";7;2021-02-14;"2021";39970;526902
2021-02-16;4813246;10884;30950;514998;"2021-W07";7;2021-02-14;"2021";41834;484048
2021-02-17;5289578;12284;34027;576870;"2021-W07";7;2021-02-14;"2021";46311;542843
2021-02-18;5578219;15009;39620;616240;"2021-W07";7;2021-02-14;"2021";54629;576620
2021-02-19;5573897;14867;42034;617424;"2021-W07";7;2021-02-14;"2021";56901;575390
2021-02-20;3475300;7010;25498;419993;"2021-W07";7;2021-02-14;"2021";32508;394495
2021-02-21;1788323;3297;13176;257313;"2021-W08";8;2021-02-21;"2021";16473;244137
2021-02-22;5430244;16526;47603;601271;"2021-W08";8;2021-02-21;"2021";64129;553668
2021-02-23;5535967;17792;50857;606171;"2021-W08";8;2021-02-21;"2021";68649;555314
2021-02-24;5368611;17480;49835;575239;"2021-W08";8;2021-02-21;"2021";67315;525404
2021-02-25;5258029;17083;50177;554758;"2021-W08";8;2021-02-21;"2021";67260;504581
2021-02-26;4931211;15444;44848;531070;"2021-W08";8;2021-02-21;"2021";60292;486222
2021-02-27;2719088;6071;23388;326124;"2021-W08";8;2021-02-21;"2021";29459;302736
2021-02-28;1371311;2866;11374;196344;"2021-W09";9;2021-02-28;"2021";14240;184970
2021-03-01;5395437;18537;55095;614641;"2021-W09";9;2021-02-28;"2021";73632;559546
2021-03-02;5496663;20449;63674;616297;"2021-W09";9;2021-02-28;"2021";84123;552623
2021-03-03;5494445;20923;67191;621140;"2021-W09";9;2021-02-28;"2021";88114;553949
2021-03-04;5380913;20152;66071;591054;"2021-W09";9;2021-02-28;"2021";86223;524983
2021-03-05;5212443;18427;63373;602216;"2021-W09";9;2021-02-28;"2021";81800;538843
2021-03-06;2335523;4916;19229;275308;"2021-W09";9;2021-02-28;"2021";24145;256079
2021-03-07;1128640;2053;9464;161499;"2021-W10";10;2021-03-07;"2021";11517;152035
2021-03-08;4743908;16242;45982;539173;"2021-W10";10;2021-03-07;"2021";62224;493191
2021-03-09;4802017;17288;50083;536172;"2021-W10";10;2021-03-07;"2021";67371;486089
2021-03-10;4837342;17752;52655;544855;"2021-W10";10;2021-03-07;"2021";70407;492200
2021-03-11;4670093;16898;51740;494471;"2021-W10";10;2021-03-07;"2021";68638;442731
2021-03-12;4706428;15635;51979;514283;"2021-W10";10;2021-03-07;"2021";67614;462304
2021-03-13;2698193;6140;29854;333735;"2021-W10";10;2021-03-07;"2021";35994;303881
2021-03-14;1360451;2757;14206;199329;"2021-W11";11;2021-03-14;"2021";16963;185123
2021-03-15;4151162;12959;42633;436988;"2021-W11";11;2021-03-14;"2021";55592;394355
2021-03-16;4130228;13570;41991;428871;"2021-W11";11;2021-03-14;"2021";55561;386880
2021-03-17;3872662;11785;37530;408568;"2021-W11";11;2021-03-14;"2021";49315;371038
2021-03-18;4070514;12045;38788;412009;"2021-W11";11;2021-03-14;"2021";50833;373221
2021-03-19;4178470;11712;38672;443136;"2021-W11";11;2021-03-14;"2021";50384;404464
2021-03-20;2484593;5145;23038;295508;"2021-W11";11;2021-03-14;"2021";28183;272470
2021-03-21;1220649;2296;11165;166619;"2021-W12";12;2021-03-21;"2021";13461;155454
2021-03-22;4058560;11324;35883;431804;"2021-W12";12;2021-03-21;"2021";47207;395921
2021-03-23;4126040;12230;36549;434570;"2021-W12";12;2021-03-21;"2021";48779;398021
2021-03-24;4114262;11954;35274;438449;"2021-W12";12;2021-03-21;"2021";47228;403175
2021-03-25;4223338;11972;35815;462564;"2021-W12";12;2021-03-21;"2021";47787;426749
2021-03-26;3506413;8154;27964;413318;"2021-W12";12;2021-03-21;"2021";36118;385354
2021-03-27;2310305;4520;19306;285106;"2021-W12";12;2021-03-21;"2021";23826;265800
2021-03-28;1188524;2022;9539;165704;"2021-W13";13;2021-03-28;"2021";11561;156165
2021-03-29;3312844;7487;24432;389594;"2021-W13";13;2021-03-28;"2021";31919;365162
2021-03-30;3421758;7726;24711;402739;"2021-W13";13;2021-03-28;"2021";32437;378028
2021-03-31;3616188;7892;26219;444095;"2021-W13";13;2021-03-28;"2021";34111;417876
2021-04-01;3668009;8017;29820;457441;"2021-W13";13;2021-03-28;"2021";37837;427621
2021-04-02;1657158;3066;15278;216989;"2021-W13";13;2021-03-28;"2021";18344;201711
2021-04-03;2291457;4247;22479;308669;"2021-W13";13;2021-03-28;"2021";26726;286190
2021-04-04;1287712;2307;13318;180940;"2021-W14";14;2021-04-04;"2021";15625;167622
2021-04-05;4234091;11605;40542;506206;"2021-W14";14;2021-04-04;"2021";52147;465664
2021-04-06;4192001;12441;33573;473810;"2021-W14";14;2021-04-04;"2021";46014;440237
2021-04-07;4370821;13580;38832;513652;"2021-W14";14;2021-04-04;"2021";52412;474820
2021-04-08;4431944;13674;42076;518775;"2021-W14";14;2021-04-04;"2021";55750;476699
2021-04-09;4449024;13268;43188;516537;"2021-W14";14;2021-04-04;"2021";56456;473349
2021-04-10;2694109;6264;27673;338715;"2021-W14";14;2021-04-04;"2021";33937;311042
2021-04-11;1300340;2714;12981;185589;"2021-W15";15;2021-04-11;"2021";15695;172608
2021-04-12;4420457;15107;45374;500274;"2021-W15";15;2021-04-11;"2021";60481;454900
2021-04-13;4443367;15904;47979;478270;"2021-W15";15;2021-04-11;"2021";63883;430291
2021-04-14;4525798;17074;52044;495580;"2021-W15";15;2021-04-11;"2021";69118;443536
2021-04-15;4534824;16995;52650;482511;"2021-W15";15;2021-04-11;"2021";69645;429861
2021-04-16;4571167;16584;53333;498019;"2021-W15";15;2021-04-11;"2021";69917;444686
2021-04-17;2685110;6812;29276;323588;"2021-W15";15;2021-04-11;"2021";36088;294312
2021-04-18;1371633;3191;14429;193357;"2021-W16";16;2021-04-18;"2021";17620;178928
2021-04-19;4557839;16921;51278;489925;"2021-W16";16;2021-04-18;"2021";68199;438647
2021-04-20;4642080;17907;51997;491496;"2021-W16";16;2021-04-18;"2021";69904;439499
2021-04-21;2242833;5382;21501;287711;"2021-W16";16;2021-04-18;"2021";26883;266210
2021-04-22;4679612;18148;51376;491229;"2021-W16";16;2021-04-18;"2021";69524;439853
2021-04-23;4695696;17005;49526;506947;"2021-W16";16;2021-04-18;"2021";66531;457421
2021-04-24;2832590;7822;30880;334007;"2021-W16";16;2021-04-18;"2021";38702;303127
2021-04-25;1289306;3109;13569;181352;"2021-W17";17;2021-04-25;"2021";16678;167783
2021-04-26;4803768;18237;50786;524807;"2021-W17";17;2021-04-25;"2021";69023;474021
2021-04-27;4881311;19644;51752;521412;"2021-W17";17;2021-04-25;"2021";71396;469660
2021-04-28;4853444;19680;51441;533793;"2021-W17";17;2021-04-25;"2021";71121;482352
2021-04-29;4585632;18216;47149;482421;"2021-W17";17;2021-04-25;"2021";65365;435272
2021-04-30;4885074;17840;47802;540376;"2021-W17";17;2021-04-25;"2021";65642;492574
2021-05-01;2421214;6597;26034;313840;"2021-W17";17;2021-04-25;"2021";32631;287806
2021-05-02;1365778;3452;16449;189747;"2021-W18";18;2021-05-02;"2021";19901;173298
2021-05-03;4923386;19743;61212;560707;"2021-W18";18;2021-05-02;"2021";80955;499495
2021-05-04;4949084;21743;66344;559686;"2021-W18";18;2021-05-02;"2021";88087;493342
2021-05-05;4630903;20774;63334;525017;"2021-W18";18;2021-05-02;"2021";84108;461683
2021-05-06;4684570;21017;55109;524807;"2021-W18";18;2021-05-02;"2021";76126;469698
2021-05-07;5037374;21611;62765;563825;"2021-W18";18;2021-05-02;"2021";84376;501060
2021-05-08;3053562;10086;41181;354421;"2021-W18";18;2021-05-02;"2021";51267;313240
2021-05-09;1418957;3654;17777;181978;"2021-W19";19;2021-05-09;"2021";21431;164201
2021-05-10;4266541;18702;56475;481126;"2021-W19";19;2021-05-09;"2021";75177;424651
2021-05-11;4453904;20932;62204;495305;"2021-W19";19;2021-05-09;"2021";83136;433101
2021-05-12;3937950;18485;54099;418502;"2021-W19";19;2021-05-09;"2021";72584;364403
2021-05-13;4108209;19624;57807;426981;"2021-W19";19;2021-05-09;"2021";77431;369174
2021-05-14;4792063;21719;66695;524125;"2021-W19";19;2021-05-09;"2021";88414;457430
2021-05-15;2840933;9383;40001;330724;"2021-W19";19;2021-05-09;"2021";49384;290723
2021-05-16;1363021;4109;17861;184457;"2021-W20";20;2021-05-16;"2021";21970;166596
2021-05-17;4333651;19626;57723;481560;"2021-W20";20;2021-05-16;"2021";77349;423837
2021-05-18;4542018;21873;59460;492338;"2021-W20";20;2021-05-16;"2021";81333;432878
2021-05-19;4312186;18082;53508;455551;"2021-W20";20;2021-05-16;"2021";71590;402043
2021-05-20;4458593;20917;55251;474868;"2021-W20";20;2021-05-16;"2021";76168;419617
2021-05-21;5024343;22247;60145;543904;"2021-W20";20;2021-05-16;"2021";82392;483759
2021-05-22;2804674;8773;32252;300463;"2021-W20";20;2021-05-16;"2021";41025;268211
2021-05-23;1342799;3947;15370;178426;"2021-W21";21;2021-05-23;"2021";19317;163056
2021-05-24;4663085;20885;52703;509544;"2021-W21";21;2021-05-23;"2021";73588;456841
2021-05-25;4778612;22333;53603;523401;"2021-W21";21;2021-05-23;"2021";75936;469798
2021-05-26;4740454;22023;53517;523938;"2021-W21";21;2021-05-23;"2021";75540;470421
2021-05-27;4427952;20154;47414;470036;"2021-W21";21;2021-05-23;"2021";67568;422622
2021-05-28;4993222;21387;51978;552234;"2021-W21";21;2021-05-23;"2021";73365;500256
2021-05-29;2961450;9421;32436;342216;"2021-W21";21;2021-05-23;"2021";41857;309780
2021-05-30;1306915;3431;12908;175418;"2021-W22";22;2021-05-30;"2021";16339;162510
2021-05-31;4069135;16543;38068;448325;"2021-W22";22;2021-05-30;"2021";54611;410257
2021-06-01;4591808;21122;49454;528952;"2021-W22";22;2021-05-30;"2021";70576;479498
2021-06-02;4607678;22428;62884;535007;"2021-W22";22;2021-05-30;"2021";85312;472123
2021-06-03;3283352;15429;49126;356107;"2021-W22";22;2021-05-30;"2021";64555;306981
2021-06-04;4782298;20987;69189;566162;"2021-W22";22;2021-05-30;"2021";90176;496973
2021-06-05;2891859;10430;45689;342239;"2021-W22";22;2021-05-30;"2021";56119;296550
2021-06-06;1354426;4410;17883;183674;"2021-W23";23;2021-06-06;"2021";22293;165791
2021-06-07;4490263;22357;60132;516829;"2021-W23";23;2021-06-06;"2021";82489;456697
2021-06-08;4566511;24034;66224;516596;"2021-W23";23;2021-06-06;"2021";90258;450372
2021-06-09;4625778;24865;70553;528473;"2021-W23";23;2021-06-06;"2021";95418;457920
2021-06-10;4639495;24351;71685;504268;"2021-W23";23;2021-06-06;"2021";96036;432583
2021-06-11;5051945;25734;79295;536975;"2021-W23";23;2021-06-06;"2021";105029;457680
2021-06-12;3162275;12488;54227;369802;"2021-W23";23;2021-06-06;"2021";66715;315575
2021-06-13;1473733;5127;23447;200556;"2021-W24";24;2021-06-13;"2021";28574;177109
2021-06-14;4385340;23570;66239;486927;"2021-W24";24;2021-06-13;"2021";89809;420688
2021-06-15;4562587;24479;69662;506772;"2021-W24";24;2021-06-13;"2021";94141;437110
2021-06-16;4598433;24875;70133;505312;"2021-W24";24;2021-06-13;"2021";95008;435179
2021-06-17;4401815;23138;63548;457281;"2021-W24";24;2021-06-13;"2021";86686;393733
2021-06-18;4773267;23360;65155;507856;"2021-W24";24;2021-06-13;"2021";88515;442701
2021-06-19;2869755;11010;39369;318728;"2021-W24";24;2021-06-13;"2021";50379;279359
2021-06-20;1359561;4603;18799;183938;"2021-W25";25;2021-06-20;"2021";23402;165139
2021-06-21;3943708;19159;51170;423600;"2021-W25";25;2021-06-20;"2021";70329;372430
2021-06-22;4245647;21150;54200;439585;"2021-W25";25;2021-06-20;"2021";75350;385385
2021-06-23;4426054;21845;55556;472695;"2021-W25";25;2021-06-20;"2021";77401;417139
2021-06-24;4533442;21607;54911;476611;"2021-W25";25;2021-06-20;"2021";76518;421700
2021-06-25;5075023;22480;59850;554493;"2021-W25";25;2021-06-20;"2021";82330;494643
2021-06-26;3078391;10920;38323;365266;"2021-W25";25;2021-06-20;"2021";49243;326943
2021-06-27;1488312;5046;18228;208568;"2021-W26";26;2021-06-27;"2021";23274;190340
2021-06-28;4444482;19147;48718;493034;"2021-W26";26;2021-06-27;"2021";67865;444316
2021-06-29;4304978;18485;44536;436478;"2021-W26";26;2021-06-27;"2021";63021;391942
2021-06-30;4276368;17683;43196;466578;"2021-W26";26;2021-06-27;"2021";60879;423382
2021-07-01;4327629;17087;46374;467603;"2021-W26";26;2021-06-27;"2021";63461;421229
2021-07-02;5115474;19715;66880;575623;"2021-W26";26;2021-06-27;"2021";86595;508743
2021-07-03;3003176;10457;45159;363631;"2021-W26";26;2021-06-27;"2021";55616;318472
2021-07-04;1409194;4049;21092;195368;"2021-W27";27;2021-07-04;"2021";25141;174276
2021-07-05;4329213;16605;61905;506053;"2021-W27";27;2021-07-04;"2021";78510;444148
2021-07-06;4433213;17296;50257;513341;"2021-W27";27;2021-07-04;"2021";67553;463084
2021-07-07;4579953;17607;55205;542361;"2021-W27";27;2021-07-04;"2021";72812;487156
2021-07-08;5200731;19366;62656;604346;"2021-W27";27;2021-07-04;"2021";82022;541690
2021-07-09;2662141;8057;30423;326333;"2021-W27";27;2021-07-04;"2021";38480;295910
2021-07-10;2935644;8701;34800;377465;"2021-W27";27;2021-07-04;"2021";43501;342665
2021-07-11;1478638;4151;16456;206379;"2021-W28";28;2021-07-11;"2021";20607;189923
2021-07-12;4669179;15954;45942;547552;"2021-W28";28;2021-07-11;"2021";61896;501610
2021-07-13;4820488;16215;45061;545073;"2021-W28";28;2021-07-11;"2021";61276;500012
2021-07-14;4789871;15715;41984;547513;"2021-W28";28;2021-07-11;"2021";57699;505529
2021-07-15;4817401;15060;37748;518378;"2021-W28";28;2021-07-11;"2021";52808;480630
2021-07-16;4970778;14902;37104;547425;"2021-W28";28;2021-07-11;"2021";52006;510321
2021-07-17;3001266;8013;25666;347012;"2021-W28";28;2021-07-11;"2021";33679;321346
2021-07-18;1481013;3839;12773;205638;"2021-W29";29;2021-07-18;"2021";16612;192865
2021-07-19;4547120;13286;29754;511287;"2021-W29";29;2021-07-18;"2021";43040;481533
2021-07-20;4570933;13167;27984;502267;"2021-W29";29;2021-07-18;"2021";41151;474283
2021-07-21;4595803;13354;26875;509693;"2021-W29";29;2021-07-18;"2021";40229;482818
2021-07-22;4649836;13014;25716;498886;"2021-W29";29;2021-07-18;"2021";38730;473170
2021-07-23;5000673;13501;26564;549293;"2021-W29";29;2021-07-18;"2021";40065;522729
2021-07-24;3122110;7807;21128;371877;"2021-W29";29;2021-07-18;"2021";28935;350749
2021-07-25;1505041;3593;9895;206285;"2021-W30";30;2021-07-25;"2021";13488;196390
2021-07-26;4414413;11626;21019;498527;"2021-W30";30;2021-07-25;"2021";32645;477508
2021-07-27;4452172;12078;20507;501297;"2021-W30";30;2021-07-25;"2021";32585;480790
2021-07-28;4117249;9947;15023;381583;"2021-W30";30;2021-07-25;"2021";24970;366560
2021-07-29;4513539;11463;18015;480406;"2021-W30";30;2021-07-25;"2021";29478;462391
2021-07-30;4915486;11794;19767;530659;"2021-W30";30;2021-07-25;"2021";31561;510892
2021-07-31;3023767;6895;16467;350867;"2021-W30";30;2021-07-25;"2021";23362;334400
2021-08-01;1392340;3244;11933;189086;"2021-W31";31;2021-08-01;"2021";15177;177153
2021-08-02;4494561;19298;59633;499463;"2021-W31";31;2021-08-01;"2021";78931;439830
2021-08-03;4838057;24922;84257;525091;"2021-W31";31;2021-08-01;"2021";109179;440834
2021-08-04;4985943;27665;94488;561333;"2021-W31";31;2021-08-01;"2021";122153;466845
2021-08-05;5086312;28746;98614;563052;"2021-W31";31;2021-08-01;"2021";127360;464438
2021-08-06;5537159;30802;92126;638870;"2021-W31";31;2021-08-01;"2021";122928;546744
2021-08-07;3419556;13905;60898;399412;"2021-W31";31;2021-08-01;"2021";74803;338514
2021-08-08;1683558;5766;27211;222127;"2021-W32";32;2021-08-08;"2021";32977;194916
2021-08-09;4916277;30406;103263;558303;"2021-W32";32;2021-08-08;"2021";133669;455040
2021-08-10;4900030;32545;106557;548507;"2021-W32";32;2021-08-08;"2021";139102;441950
2021-08-11;5784598;38958;133289;640284;"2021-W32";32;2021-08-08;"2021";172247;506995
2021-08-12;5696908;38675;131924;599916;"2021-W32";32;2021-08-08;"2021";170599;467992
2021-08-13;5602324;36300;125280;572474;"2021-W32";32;2021-08-08;"2021";161580;447194
2021-08-14;3578835;16348;70955;416899;"2021-W32";32;2021-08-08;"2021";87303;345944
2021-08-15;1882407;8064;37033;261207;"2021-W33";33;2021-08-15;"2021";45097;224174
2021-08-16;5506094;39114;131186;588801;"2021-W33";33;2021-08-15;"2021";170300;457615
2021-08-17;5789762;42727;141167;640391;"2021-W33";33;2021-08-15;"2021";183894;499224
2021-08-18;5821318;43426;137148;644141;"2021-W33";33;2021-08-15;"2021";180574;506993
2021-08-19;5809051;43358;136927;624214;"2021-W33";33;2021-08-15;"2021";180285;487287
2021-08-20;5838501;41077;130501;636453;"2021-W33";33;2021-08-15;"2021";171578;505952
2021-08-21;3700388;18077;75848;437010;"2021-W33";33;2021-08-15;"2021";93925;361162
2021-08-22;1952592;8940;39297;269288;"2021-W34";34;2021-08-22;"2021";48237;229991
2021-08-23;5656926;42425;135175;619494;"2021-W34";34;2021-08-22;"2021";177600;484319
2021-08-24;5816191;44578;142252;626079;"2021-W34";34;2021-08-22;"2021";186830;483827
2021-08-25;5922040;46262;146364;653825;"2021-W34";34;2021-08-22;"2021";192626;507461
2021-08-26;5877488;45129;144156;627956;"2021-W34";34;2021-08-22;"2021";189285;483800
2021-08-27;5771943;40975;131589;613992;"2021-W34";34;2021-08-22;"2021";172564;482403
2021-08-28;3125024;13875;57561;323506;"2021-W34";34;2021-08-22;"2021";71436;265945
2021-08-29;1808084;7512;34304;247039;"2021-W35";35;2021-08-29;"2021";41816;212735
2021-08-30;5667765;41450;134210;629182;"2021-W35";35;2021-08-29;"2021";175660;494972
2021-08-31;5945251;44282;143715;661504;"2021-W35";35;2021-08-29;"2021";187997;517789
2021-09-01;6037850;47983;155999;684673;"2021-W35";35;2021-08-29;"2021";203982;528674
2021-09-02;6020791;49449;165667;670885;"2021-W35";35;2021-08-29;"2021";215116;505218
2021-09-03;6028733;47588;165689;688769;"2021-W35";35;2021-08-29;"2021";213277;523080
2021-09-04;3759020;20676;92795;452076;"2021-W35";35;2021-08-29;"2021";113471;359281
2021-09-05;1977006;10233;48122;275294;"2021-W36";36;2021-09-05;"2021";58355;227172
2021-09-06;4708808;24462;79765;571029;"2021-W36";36;2021-09-05;"2021";104227;491264
2021-09-07;2406237;12083;49527;293802;"2021-W36";36;2021-09-05;"2021";61610;244275
2021-09-08;6135235;52999;155175;738997;"2021-W36";36;2021-09-05;"2021";208174;583822
2021-09-09;6060061;53553;163158;674215;"2021-W36";36;2021-09-05;"2021";216711;511057
2021-09-10;6069484;51041;163514;678799;"2021-W36";36;2021-09-05;"2021";214555;515285
2021-09-11;3856828;23437;97934;462798;"2021-W36";36;2021-09-05;"2021";121371;364864
2021-09-12;2040283;11431;52267;283675;"2021-W37";37;2021-09-12;"2021";63698;231408
2021-09-13;5922483;54067;176234;671822;"2021-W37";37;2021-09-12;"2021";230301;495588
2021-09-14;6043881;57078;185859;670850;"2021-W37";37;2021-09-12;"2021";242937;484991
2021-09-15;6006653;57676;188328;657414;"2021-W37";37;2021-09-12;"2021";246004;469086
2021-09-16;5903931;55550;185477;620913;"2021-W37";37;2021-09-12;"2021";241027;435436
2021-09-17;5853673;52672;180795;637851;"2021-W37";37;2021-09-12;"2021";233467;457056
2021-09-18;3504284;22230;96591;412125;"2021-W37";37;2021-09-12;"2021";118821;315534
2021-09-19;1734310;10015;48190;239880;"2021-W38";38;2021-09-19;"2021";58205;191690
2021-09-20;5410674;51253;175405;591574;"2021-W38";38;2021-09-19;"2021";226658;416169
2021-09-21;5335815;51482;175983;566862;"2021-W38";38;2021-09-19;"2021";227465;390879
2021-09-22;5315257;51354;176228;561947;"2021-W38";38;2021-09-19;"2021";227582;385719
2021-09-23;5215339;49890;171071;553480;"2021-W38";38;2021-09-19;"2021";220961;382409
2021-09-24;5749782;50653;184753;626310;"2021-W38";38;2021-09-19;"2021";235406;441557
2021-09-25;3208069;19408;88948;360341;"2021-W38";38;2021-09-19;"2021";108356;271393
2021-09-26;1703630;10093;46938;230214;"2021-W39";39;2021-09-26;"2021";57031;183276
2021-09-27;5403384;50509;177542;603982;"2021-W39";39;2021-09-26;"2021";228051;426440
2021-09-28;5351686;50101;175691;594362;"2021-W39";39;2021-09-26;"2021";225792;418671
2021-09-29;5856620;55298;191545;651898;"2021-W39";39;2021-09-26;"2021";246843;460353
2021-09-30;5374112;49021;169363;592205;"2021-W39";39;2021-09-26;"2021";218384;422842
2021-10-01;5695883;49536;177851;622842;"2021-W39";39;2021-09-26;"2021";227387;444991
2021-10-02;3295003;21257;94893;386460;"2021-W39";39;2021-09-26;"2021";116150;291567
2021-10-03;1405445;7901;36751;187147;"2021-W40";40;2021-10-03;"2021";44652;150396
2021-10-04;5205310;50323;169729;579701;"2021-W40";40;2021-10-03;"2021";220052;409972
2021-10-05;5317961;54420;178867;606449;"2021-W40";40;2021-10-03;"2021";233287;427582
2021-10-06;5676058;58915;157334;661696;"2021-W40";40;2021-10-03;"2021";216249;504362
2021-10-07;5429309;56291;160380;606271;"2021-W40";40;2021-10-03;"2021";216671;445891
2021-10-08;6228433;60717;184837;716239;"2021-W40";40;2021-10-03;"2021";245554;531402
2021-10-09;3633715;23952;99341;407566;"2021-W40";40;2021-10-03;"2021";123293;308225
2021-10-10;1798540;10803;48576;236867;"2021-W41";41;2021-10-10;"2021";59379;188291
2021-10-11;4420811;27506;103186;506915;"2021-W41";41;2021-10-10;"2021";130692;403729
2021-10-12;2009479;12626;56174;248924;"2021-W41";41;2021-10-10;"2021";68800;192750
2021-10-13;5432622;55326;161183;624920;"2021-W41";41;2021-10-10;"2021";216509;463737
2021-10-14;5155362;53492;155631;575577;"2021-W41";41;2021-10-10;"2021";209123;419946
2021-10-15;5413620;50499;155992;594699;"2021-W41";41;2021-10-10;"2021";206491;438707
2021-10-16;3173731;21842;94580;369591;"2021-W41";41;2021-10-10;"2021";116422;275011
2021-10-17;1486776;9208;43948;202981;"2021-W42";42;2021-10-17;"2021";53156;159033
2021-10-18;4883747;53104;168647;494487;"2021-W42";42;2021-10-17;"2021";221751;325840
2021-10-19;5168856;59466;189664;549425;"2021-W42";42;2021-10-17;"2021";249130;359761
2021-10-20;5425569;61107;198173;589414;"2021-W42";42;2021-10-17;"2021";259280;391241
2021-10-21;5701126;64412;212581;613888;"2021-W42";42;2021-10-17;"2021";276993;401307
2021-10-22;6271124;65927;230515;689930;"2021-W42";42;2021-10-17;"2021";296442;459415
2021-10-23;3680067;27787;120046;428282;"2021-W42";42;2021-10-17;"2021";147833;308236
2021-10-24;1568697;9964;45958;202829;"2021-W43";43;2021-10-24;"2021";55922;156871
2021-10-25;5567831;61161;220118;618903;"2021-W43";43;2021-10-24;"2021";281279;398785
2021-10-26;5368771;59899;209933;586472;"2021-W43";43;2021-10-24;"2021";269832;376539
2021-10-27;5638616;61964;212642;619579;"2021-W43";43;2021-10-24;"2021";274606;406937
2021-10-28;5733910;62170;208173;617833;"2021-W43";43;2021-10-24;"2021";270343;409660
2021-10-29;6319542;62396;219341;712936;"2021-W43";43;2021-10-24;"2021";281737;493595
2021-10-30;3838376;25882;115513;458386;"2021-W43";43;2021-10-24;"2021";141395;342873
2021-10-31;1903007;11999;54104;257801;"2021-W44";44;2021-10-31;"2021";66103;203697
2021-11-01;4388157;27100;115189;508915;"2021-W44";44;2021-10-31;"2021";142289;393726
2021-11-02;2119226;13381;62530;287299;"2021-W44";44;2021-10-31;"2021";75911;224769
2021-11-03;5650356;66101;261471;665836;"2021-W44";44;2021-10-31;"2021";327572;404365
2021-11-04;5704793;68701;270397;651291;"2021-W44";44;2021-10-31;"2021";339098;380894
2021-11-05;6224855;72141;281570;717102;"2021-W44";44;2021-10-31;"2021";353711;435532
2021-11-06;3779947;30759;107750;444287;"2021-W44";44;2021-10-31;"2021";138509;336537
2021-11-07;2229834;16867;66928;307548;"2021-W45";45;2021-11-07;"2021";83795;240620
2021-11-08;6469966;80174;287503;754115;"2021-W45";45;2021-11-07;"2021";367677;466612
2021-11-09;6214641;79269;296365;698982;"2021-W45";45;2021-11-07;"2021";375634;402617
2021-11-10;5638428;72614;264309;637548;"2021-W45";45;2021-11-07;"2021";336923;373239
2021-11-11;5477285;69893;261438;568799;"2021-W45";45;2021-11-07;"2021";331331;307361
2021-11-12;6336724;76248;288514;687828;"2021-W45";45;2021-11-07;"2021";364762;399314
2021-11-13;3874415;30516;127809;456526;"2021-W45";45;2021-11-07;"2021";158325;328717
2021-11-14;2029465;16226;67281;271574;"2021-W46";46;2021-11-14;"2021";83507;204293
2021-11-15;2128489;15468;69305;267670;"2021-W46";46;2021-11-14;"2021";84773;198365
2021-11-16;5506917;68412;273012;634074;"2021-W46";46;2021-11-14;"2021";341424;361062
2021-11-17;5755540;72924;289336;641069;"2021-W46";46;2021-11-14;"2021";362260;351733
2021-11-18;6356161;79579;316912;662778;"2021-W46";46;2021-11-14;"2021";396491;345866
2021-11-19;5922183;69485;274902;598724;"2021-W46";46;2021-11-14;"2021";344387;323822
2021-11-20;3376190;26609;115881;409263;"2021-W46";46;2021-11-14;"2021";142490;293382
2021-11-21;1807312;14680;69218;244276;"2021-W47";47;2021-11-21;"2021";83898;175058
2021-11-22;5563005;66330;275298;621188;"2021-W47";47;2021-11-21;"2021";341628;345890
2021-11-23;5724856;69651;286736;625656;"2021-W47";47;2021-11-21;"2021";356387;338920
2021-11-24;3042066;35284;146421;341663;"2021-W47";47;2021-11-21;"2021";181705;195242
2021-11-25;5730378;66481;276898;620233;"2021-W47";47;2021-11-21;"2021";343379;343335
2021-11-26;6056567;65573;274339;658706;"2021-W47";47;2021-11-21;"2021";339912;384367
2021-11-27;3777418;28952;124808;442173;"2021-W47";47;2021-11-21;"2021";153760;317365
2021-11-28;1970985;15376;69242;264366;"2021-W48";48;2021-11-28;"2021";84618;195124
2021-11-29;5618083;59374;260002;624346;"2021-W48";48;2021-11-28;"2021";319376;364344
2021-11-30;6533416;67418;289988;720185;"2021-W48";48;2021-11-28;"2021";357406;430197
2021-12-01;6476027;69311;305755;721672;"2021-W48";48;2021-11-28;"2021";375066;415917
2021-12-02;5888509;64966;279842;649423;"2021-W48";48;2021-11-28;"2021";344808;369581
2021-12-03;6272595;66736;291227;710881;"2021-W48";48;2021-11-28;"2021";357963;419654
2021-12-04;4000534;32876;140382;460731;"2021-W48";48;2021-11-28;"2021";173258;320349
2021-12-05;2032706;15921;70453;266470;"2021-W49";49;2021-12-05;"2021";86374;196017
2021-12-06;6411164;67281;249239;744130;"2021-W49";49;2021-12-05;"2021";316520;494891
2021-12-07;5989264;62494;239413;627892;"2021-W49";49;2021-12-05;"2021";301907;388479
2021-12-08;5605154;59209;223252;652858;"2021-W49";49;2021-12-05;"2021";282461;429606
2021-12-09;5642770;57677;227467;621007;"2021-W49";49;2021-12-05;"2021";285144;393540
